,Title,Women_Directors,Men_Directors,Not_Set_Directors,Total_Directors
0,Money Heist,0,5,2,7
1,The Blacklist,4,32,0,36
2,Locked Up,2,3,4,9
3,Prison Break,1,30,1,32
4,13 Reasons Why,2,5,0,7
5,Dark,0,3,0,3
6,Riverdale,2,8,0,10
7,Lucifer,4,15,1,20
8,Peaky Blinders,0,6,0,6
9,The Queen of Flow,1,1,0,2
10,Jeffrey Epstein: Filthy Rich,1,0,0,1
11,Snowpiercer,1,5,0,6
12,"Pablo Escobar, el patrón del mal",1,1,0,2
13,Breaking Bad,3,22,1,26
14,White Lines,1,2,1,4
15,Narcos,0,9,2,11
16,La piloto,0,5,0,5
17,La Reina del Sur,0,2,0,2
18,Toy Boy,1,2,1,4
19,Unauthorized Living,1,5,1,7
20,Arrow,7,37,2,46
21,Ozark,3,8,0,11
22,How to Get Away With Murder,7,17,0,24
23,Sons of Anarchy,2,19,0,21
24,El Dragón: Return of a Warrior,0,3,0,3
25,The Alcàsser Murders,0,0,1,1
26,The Sinner,1,4,0,5
27,Queen of the South,1,3,2,6
28,Surviving Escobar - Alias JJ,0,3,0,3
29,Narcos: Mexico,1,6,1,8
30,You,9,7,0,16
31,El Chapo,1,3,0,4
32,Brooklyn Nine-Nine,7,39,0,46
33,Nicky Jam: El Ganador,1,0,0,1
34,Cocaine Coast,0,3,0,3
35,Titans,0,6,0,6
36,Designated Survivor,1,13,0,14
37,Scorpion,2,5,0,7
38,The Woods,0,2,0,2
39,Las muñecas de la mafia,0,2,0,2
40,Marvel's Iron Fist,2,11,0,13
41,Fauda,0,4,0,4
42,Better Call Saul,4,11,0,15
43,MINDHUNTER,0,7,0,7
44,Shooter,2,8,0,10
45,Gotham,7,21,1,29
46,Mar de plástico,0,2,0,2
47,The Search,2,1,0,3
48,Enemigo íntimo,0,2,0,2
49,Sherlock,0,9,0,9
50,One-Punch Man,0,4,2,6
51,Marvel's The Punisher,5,15,0,20
52,When They See Us,2,0,0,2
53,Dueños del paraíso,1,1,2,4
54,La Niña,0,2,0,2
55,Black Money Love,0,1,0,1
56,La bella y las bestias,0,1,0,1
57,The Inmate,1,3,0,4
58,Marvel's Daredevil,2,16,0,18
59,High Seas,1,4,0,5
60,Falsa identidad,0,3,0,3
61,The Disappearance of Madeleine McCann,0,1,0,1
62,The Alienist,0,5,0,5
63,Dare Me,5,2,0,7
64,Broadchurch,1,8,0,9
65,Unbelievable,4,2,0,6
66,Freud,0,1,0,1
67,Bodyguard,0,3,0,3
68,Travelers,0,5,0,5
69,"Tiger King: Murder, Mayhem and Madness",1,1,0,2
70,Henry Danger,1,6,0,7
71,Valeria,3,0,0,3
72,Modern Family,6,25,0,31
73,Sex Education,4,1,0,5
74,Friends,8,22,0,30
75,The Big Bang Theory,1,11,0,12
76,The Loud House,0,3,0,3
77,SpongeBob SquarePants,0,14,0,14
78,Teen Titans Go!,1,15,0,16
79,Chica Vampiro,0,2,1,3
80,Fuller House,2,9,0,11
81,The Boss Baby: Back in Business,0,8,0,8
82,Never Have I Ever,1,3,0,4
83,Suits,2,8,0,10
84,Sonic Boom,2,1,0,3
85,Victorious,0,6,0,6
86,Clarence,1,5,0,6
87,How I Met Your Mother,1,5,0,6
88,The House of Flowers,0,5,1,6
89,The Fresh Prince of Bel-Air,7,5,0,12
90,Pup Academy,1,2,0,3
91,Sam & Cat,0,4,0,4
92,A Series of Unfortunate Events,1,8,0,9
93,Insatiable,3,4,0,7
94,Paquita Salas,0,3,0,3
95,Jane The Virgin,13,9,1,23
96,Orange Is the New Black,3,5,0,8
97,Gilmore Girls,4,14,0,18
98,iZombie,2,14,1,17
99,The Garfield Show,0,1,0,1
100,The End of the F***ing World,2,3,0,5
101,Space Force,0,4,0,4
102,Atypical,6,8,0,14
103,Disenchantment,1,8,0,9
104,Adventure Time,4,12,0,16
105,Kipo and the Age of Wonderbeasts,0,2,0,2
106,Malibu Rescue: The Series,1,2,0,3
107,Dead to Me,4,1,0,5
108,The Road to Love,0,2,0,2
109,Regular Show,0,2,1,3
110,Glee,2,12,0,14
111,The InBESTigators,2,3,0,5
112,The Big Show Show,1,2,0,3
113,Workin' Moms,6,2,0,8
114,The Good Place,5,11,0,16
115,Rabbids Invasion,0,5,0,5
116,We Bare Bears,0,2,0,2
117,Grace and Frankie,8,18,0,26
118,On My Block,1,2,0,3
119,I Am Not Okay With This,0,1,0,1
120,Grizzy and the Lemmings,0,1,0,1
121,Community,4,22,0,26
122,Barbie Life in the Dreamhouse,0,1,0,1
123,Rebelde Way,1,2,0,3
124,The Epic Tales of Captain Underpants,0,1,0,1
125,The Neighbor,3,5,1,9
126,Crash Landing on You,0,1,0,1
127,Angry Birds,0,3,0,3
128,Pac-Man and the Ghostly Adventures,0,1,0,1
129,You Me Her,1,1,0,2
130,Larva,0,0,1,1
131,Always a Witch,1,1,0,2
132,Larva Island,0,0,1,1
133,The Hockey Girls,1,1,0,2
134,Dragons: Rescue Riders,0,3,1,4
135,Good Girls,3,4,1,8
136,Trolls: The Beat Goes On!,1,4,0,5
137,How to Sell Drugs Online (Fast),0,4,0,4
138,Skylanders Academy,0,1,0,1
139,Daybreak,1,5,0,6
140,PAW Patrol,0,3,0,3
141,Stranger Things,1,5,0,6
142,The Last Dance,0,1,0,1
143,The 100,1,16,2,19
144,Cable Girls,1,5,0,6
145,Peppa Pig,0,3,0,3
146,Miraculous: Tales of Ladybug & Cat Noir,0,1,0,1
147,Anne with an E,3,1,0,4
148,Vikings,4,9,0,13
149,H2O: Just Add Water,0,3,0,3
150,ALVINNN!!! And the Chipmunks,1,0,0,1
151,Naruto,2,19,0,21
152,Curon,1,5,0,6
153,Dynasty,0,1,1,2
154,Attack on Titan,1,12,2,15
155,Pokémon the Series: Sun & Moon,0,1,0,1
156,Minecraft: Story Mode,0,2,0,2
157,Mako Mermaids: An H2O Adventure,0,5,0,5
158,The Seven Deadly Sins,0,2,0,2
159,The Crown,0,5,0,5
160,Merlí,1,2,0,3
161,Sin senos sí hay paraíso,0,2,0,2
162,Outlander,2,9,0,11
163,Free Rein,0,3,0,3
164,Teen Wolf,4,11,0,15
165,The Last Kingdom,0,13,0,13
166,Barbie Dreamhouse Adventures,1,4,0,5
167,Simon,0,1,0,1
168,Avatar: The Last Airbender,1,6,0,7
169,The Witcher,2,3,0,5
170,Gossip Girl,3,14,1,18
171,Unorthodox,3,0,0,3
172,Masha and the Bear,2,7,0,9
173,Power Rangers Ninja Steel,0,7,0,7
174,Pasión de Gavilanes,0,3,0,3
175,Go! Live Your Way,0,0,2,2
176,Marvel's Jessica Jones,5,7,1,13
177,El marginal,0,4,1,5
178,The Valhalla Murders,1,1,1,3
179,Marvel's Luke Cage,4,18,0,22
180,Manhunt,0,1,0,1
181,El Chema,0,2,1,3
182,Bitter Daisies,1,3,0,4
183,Alias Grace,1,0,0,1
184,The Stranger,1,2,0,3
185,Undercover Law,0,2,1,3
186,Ingobernable,0,2,0,2
187,Luther,0,4,0,4
188,Hache,1,2,0,3
189,Suburra: Blood on Rome,1,4,0,5
190,Extracurricular,1,0,0,1
191,BAKI,0,2,0,2
192,JoJo's Bizarre Adventure,0,2,0,2
193,Haikyu!!,4,13,3,20
194,DEATH NOTE,0,0,1,1
195,Sword Art Online,3,33,5,41
196,Darling in the Franxx,0,3,0,3
197,Tokyo Ghoul,0,1,0,1
198,Fairy Tail,0,1,0,1
199,Cardcaptor Sakura,0,1,0,1
200,KENGAN ASHURA,0,1,0,1
201,BEASTARS,0,1,0,1
202,​SAINT SEIYA: Knights of the Zodiac,0,1,0,1
203,Neon Genesis Evangelion,0,1,0,1
204,Fullmetal Alchemist: Brotherhood,0,9,0,9
205,Noragami,0,1,0,1
206,Castlevania,0,4,0,4
207,Your lie in April,0,0,1,1
208,Kakegurui,0,1,0,1
209,Re:Zero - Starting Life in Another World,0,1,0,1
210,InuYasha,1,3,0,4
211,Akame ga Kill!,0,1,0,1
212,Seraph of the End,0,1,0,1
213,Dorohedoro,0,1,0,1
214,Toradora!,0,1,0,1
215,Little Witch Academia,0,9,0,9
216,Blue Exorcist,0,1,0,1
217,Is It Wrong to Try to Pick Up Girls in a Dungeon?,2,5,0,7
218,Erased,0,1,0,1
219,Psycho-Pass,0,1,0,1
220,No Game No Life,5,5,0,10
221,Saint Seiya: The Lost Canvas,1,1,0,2
222,High School of the Dead,0,0,1,1
223,The Disastrous Life of Saiki K.,0,1,0,1
224,Glitter Force,0,1,0,1
225,ReLIFE,0,1,0,1
226,Code Geass: Lelouch of the Rebellion,0,1,0,1
227,Devilman Crybaby,0,1,0,1
228,Violet Evergarden,0,1,0,1
229,Fullmetal Alchemist,1,18,1,20
230,Teasing Master Takagi-san,0,1,0,1
231,Hi Score Girl,0,1,0,1
232,Black Lagoon,0,1,1,2
233,Magi: Adventure of Sinbad,0,1,0,1
234,STEINS;GATE,0,2,0,2
235,Made in Abyss,0,1,0,1
236,The Asterisk War,0,2,0,2
237,Anohana: The Flower We Saw That Day,0,1,0,1
238,Hellsing Ultimate,0,4,0,4
239,Vampire Knight,2,1,0,3
240,The Ancient Magus' Bride,0,1,0,1
241,Saint Seiya: Soul of Gold,0,5,0,5
242,Charlotte,0,1,0,1
243,Aggretsuko,0,0,1,1
244,The Slayers,0,2,0,2
245,Gangsta.,1,0,0,1
246,Ghost in the Shell: SAC_2045,0,2,0,2
247,SWORDGAI The Animation,0,1,0,1
248,Ultramarine Magmell,0,1,0,1
249,Devil May Cry,0,1,0,1
250,Angel Beats!,0,1,0,1
251,Fate/Apocrypha,0,1,0,1
252,Fate/Zero,1,1,0,2
253,Fate/stay night: Unlimited Blade Works,0,1,0,1
254,Guilty Crown,0,0,1,1
255,The Heroic Legend of Arslan,0,1,0,1
256,A Certain Magical Index,0,1,0,1
257,Ultraman,0,2,0,2
258,Forest of Piano,0,1,1,2
259,Sword Oratoria: Is It Wrong to Try to Pick Up Girls in a Dungeon? On the Side,0,5,0,5
260,Dragons: Race to the Edge,1,6,1,8
261,Outer Banks,2,1,0,3
262,Locke & Key,2,5,0,7
263,She-Ra and the Princesses of Power,7,4,0,11
264,Trollhunters: Tales of Arcadia,2,6,0,8
265,Marvel's Agents of S.H.I.E.L.D.,8,24,0,32
266,Lost in Space,2,5,0,7
267,Raising Dion,3,3,0,6
268,Spartacus,0,5,0,5
269,The Umbrella Academy,1,5,0,6
270,You vs. Wild,0,4,0,4
271,Merlin,1,7,0,8
272,Kingdom,1,1,0,2
273,Ragnarok,0,3,0,3
274,The Dragon Prince,1,7,0,8
275,Colony,2,10,0,12
276,Timeless,1,11,0,12
277,Nowhere Boys,3,7,0,10
278,Black Sails,0,9,1,10
279,Star Trek: Discovery,0,10,1,11
280,Black Summer,0,4,0,4
281,Marco Polo,0,9,0,9
282,The Protector,1,4,0,5
283,3Below: Tales of Arcadia,2,5,0,7
284,The Adventures of Tintin,0,1,0,1
285,Another Life,1,4,1,6
286,Victim Number 8,2,2,0,4
287,V Wars,0,4,1,5
288,Frontier,1,5,0,6
289,The Shannara Chronicles,0,6,0,6
290,Black Lightning,4,8,0,12
291,The I-Land,0,4,0,4
292,Undercover,0,2,0,2
293,Betaal,1,2,0,3
294,Drug Squad: Costa del Sol,0,9,0,9
295,The New Legends of Monkey,0,2,0,2
296,Marvel's The Defenders,1,3,1,5
297,The Letter for the King,0,4,0,4
298,Troy: Fall of a City,0,3,0,3
299,You Cannot Hide,0,3,0,3
300,Wu Assassins,1,6,0,7
301,Rick and Morty,0,11,0,11
302,The Walking Dead,8,27,0,35
303,Family Guy,2,38,0,40
304,Érase una vez,1,33,0,34
305,Shadowhunters: The Mortal Instruments,4,14,3,21
306,Pose,0,3,0,3
307,Homeland,2,25,0,27
308,Our Planet,2,5,0,7
309,Virgin River,1,4,0,5
310,Formula 1: Drive to Survive,1,0,0,1
311,F is for Family,0,7,0,7
312,Chilling Adventures of Sabrina,1,6,0,7
313,Hollywood,3,5,0,8
314,House of Cards,4,15,0,19
315,South Park,0,7,0,7
316,Z Nation,2,16,0,18
317,Woman in Charge,0,2,0,2
318,Big Mouth,1,7,0,8
319,Sense8,6,3,1,10
320,When Calls the Heart,1,2,0,3
321,Mr. Sunshine,1,7,0,8
322,When the Camellia Blooms,1,0,0,1
323,Crazy Ex-Girlfriend,4,5,0,9
324,Descendants of the Sun,0,1,0,1
325,My Love from the Star,0,1,0,1
326,Reply 1988,0,1,0,1
327,Love in the Moonlight,0,2,0,2
328,Coffee Prince,0,1,0,1
329,Control Z,0,2,0,2
330,Greenhouse Academy,0,2,0,2
331,Summertime,0,2,0,2
332,Baby,3,5,0,8
333,Blood & Water,2,1,0,3
334,Love Alarm,0,1,0,1
335,The Rain,1,4,0,5
336,Boys Over Flowers,0,1,0,1
337,The Society,1,2,0,3
338,The Order,3,3,0,6
339,Dance Academy,2,5,0,7
340,Meteor Garden,0,1,0,1
341,The A List,1,4,0,5
342,3 %,1,2,2,5
343,Club 57,0,1,0,1
344,Scream,1,14,1,16
345,Love 101,0,2,0,2
346,Trinkets,6,1,0,7
347,Skins,0,3,0,3
348,Pretty Little Liars,14,17,3,34
349,Luna Nera,3,0,0,3
350,Good Morning Call,0,1,1,2
351,Everything Sucks!,0,4,0,4
352,Quicksand,0,1,0,1
353,The Unremarkable Juanquini,0,2,0,2
354,Degrassi: Next Class,1,4,0,5
355,The Politician,2,3,0,5
356,Derry Girls,1,1,0,2
357,Wolfblood,1,3,0,4
358,Vampires,0,1,0,1
359,The Prince of Tennis ~ Match! Tennis Juniors ~,0,2,0,2
360,October Faction,2,4,0,6
361,Haters Back Off,1,2,0,3
362,We Are the Wave,1,1,0,2
363,Between,0,3,0,3
364,Mortel,0,3,0,3
365,Sintonia,0,3,2,5
366,Chambers,3,2,0,5
367,Beyond Stranger Things,0,1,0,1
368,Switched,0,1,0,1
369,Superstition,1,6,0,7
370,Cheer,0,2,0,2
371,March Comes in Like a Lion,0,2,0,2
372,Kiss Me First,0,3,0,3
373,The Stranded,0,1,0,1
374,Black Mirror,0,1,0,1
375,The Queen and the Conqueror,0,3,0,3
376,Caliphate,0,3,0,3
377,Into the Night,0,3,0,3
378,La Esclava Blanca,1,1,0,2
379,My Little Pony: Friendship Is Magic,1,2,0,3
380,LEGO Ninjago: Masters of Spinjitzu,0,3,0,3
381,44 Cats,0,1,0,1
382,Pocoyo,0,1,0,1
383,Gormiti,0,3,0,3
384,PJ Masks,1,2,0,3
385,Marcus Level,0,1,0,1
386,Winx Club,0,1,0,1
387,DC Super Hero Girls,2,0,0,2
388,Chip and Potato,0,2,0,2
389,Super Wings,0,1,0,1
390,Once Upon a Time... Life,0,1,0,1
391,Mia and Me,0,4,0,4
392,Sherlock Yack – Zoo Detective,0,1,0,1
393,Octonauts,1,1,0,2
394,Spirit Riding Free,0,1,0,1
395,Young Justice,1,13,0,14
396,Little Baby Bum: Nursery Rhyme Friends,0,1,0,1
397,Robot Trains,1,0,0,1
398,The Hollow,0,3,0,3
399,Wakfu,0,1,0,1
400,Super Monsters,0,1,0,1
401,The Last Kids on Earth,0,1,0,1
402,The Adventures of Puss in Boots,1,7,0,8
403,Daniel Tiger's Neighbourhood,3,4,0,7
404,Pucca: Love Recipe,0,3,0,3
405,Hotel Transylvania,0,0,1,1
406,Ever After High,0,1,0,1
407,Fireman Sam,0,1,0,1
408,Dinotrux,1,2,0,3
409,Word Party,0,4,0,4
410,Steven Universe,1,0,0,1
411,The Worst Witch,1,1,0,2
412,Project Mc²,0,1,0,1
413,Beyblade Burst,0,1,0,1
414,Yu-Gi-Oh!,0,3,0,3
415,Yo-Kai Watch,0,2,0,2
416,Creeped Out,0,4,0,4
417,Dinosaur King,0,1,0,1
418,Sonic X,0,1,0,1
419,Reality Z,0,1,1,2
420,The Haunting of Hill House,0,2,0,2
421,Van Helsing,4,10,0,14
422,Glitch,1,0,0,1
423,Marianne,0,1,0,1
424,Bitten,1,6,2,9
425,Dracula,0,5,0,5
426,Prank Encounters,0,1,0,1
427,Santa Clarita Diet,2,8,0,10
428,Ash vs. Evil Dead,0,13,1,14
429,Wynonna Earp,1,4,0,5
430,The Mist,0,1,0,1
431,Hemlock Grove,3,16,1,20
432,Haunted,0,1,0,1
433,From Dusk Till Dawn,0,1,0,1
434,Ghost Wars,2,6,0,8
435,Nightflyers,1,5,0,6
436,Diablero,0,4,0,4
437,Immortals,0,1,0,1
438,Bloodride,0,3,0,3
439,When They Cry,1,0,0,1
440,Kabaneri of the Iron Fortress: The Battle of Unato,0,0,1,1
441,Typewriter,0,1,0,1
442,GHOUL,0,1,0,1
443,Crazyhead,0,1,0,1
444,Spectros,0,1,0,1
445,The Kirlian Frequency,0,1,0,1
446,Strangers From Hell,0,1,0,1
447,"Bring It On, Ghost",0,1,0,1
448,Until Dawn,0,1,0,1
449,Orphan Black,1,12,1,14
450,Salvation,4,11,0,15
451,Messiah,1,2,0,3
452,Line of Duty,0,7,0,7
453,The OA,2,3,0,5
454,Black Spot,0,2,0,2
455,The Forest,0,1,0,1
456,The Assassination of Gianni Versace,1,5,0,6
457,The Spy,0,2,0,2
458,Deadwind,2,0,0,2
459,WHAT / IF,2,2,1,5
460,Bloodline,0,1,0,1
461,Inhuman Resources,0,1,0,1
462,Doctor Foster,0,3,0,3
463,Safe,1,3,0,4
464,Memories of the Alhambra,0,1,0,1
465,La Mante,1,3,0,4
466,Criminal: Spain,0,3,0,3
467,Vagabond,0,1,0,1
468,Fugitiva,0,4,1,5
469,No Good Nick,1,7,1,9
470,The Kominsky Method,1,4,0,5
471,That '70s Show,1,3,0,4
472,Richie Rich,0,1,0,1
473,Team Kaylie,2,3,0,5
474,Family Reunion,0,1,0,1
475,The IT Crowd,1,0,0,1
476,Millennials,0,2,0,2
477,Some Assembly Required,2,7,0,9
478,Unbreakable Kimmy Schmidt,2,3,0,5
479,Arrested Development,1,14,0,15
480,The Ranch,0,3,0,3
481,The Thundermans,2,14,0,16
482,The Expanding Universe of Ashley Garcia,3,5,0,8
483,Disjointed,1,6,0,7
484,Trailer Park Boys,0,1,0,1
485,One Day at a Time,3,4,0,7
486,Mr. Iglesias,1,7,0,8
487,Prince of Peoria,0,2,0,2
488,Master of None,2,6,0,8
489,Lovesick,0,1,0,1
490,Marlon,0,7,0,7
491,Crashing,1,1,0,2
492,Norsemen,0,2,0,2
493,Sick Note,1,2,0,3
494,A Family Reunion Christmas,0,1,0,1
495,Derek,0,2,0,2
496,Brews Brothers,0,2,0,2
497,Great News,5,3,0,8
498,All About the Washingtons,0,1,0,1
499,Champions,1,2,0,3
500,Merry Happy Whatever,3,1,0,4
501,White Gold,0,1,0,1
502,Real Rob,0,1,0,1
503,Psiconautas,0,1,0,1
504,The Sound of Your Heart,0,1,0,1
505,Cuckoo,0,3,0,3
506,Still Game,0,1,0,1
507,BoJack Horseman Christmas Special: Sabrina's Christmas Wish,0,1,0,1
508,Toon,0,1,0,1
509,Samantha!,0,2,1,3
510,The Sound of Your Heart: Reboot,0,1,0,1
511,YG Future Strategy Office,0,0,0,0
512,Lady Dynamite,0,1,0,1
513,Brown Nation,1,0,0,1
514,Good Witch,0,1,0,1
515,My Holo Love,0,3,0,3
516,Black Mirror: Bandersnatch,0,1,0,1
517,Mars,1,4,0,5
518,Abyss,0,1,0,1
519,A Korean Odyssey,0,1,0,1
520,Better Than Us,0,4,0,4
521,Tidelands,4,4,0,8
522,The Dark Crystal: Age of Resistance,0,3,0,3
523,Dirk Gently's Holistic Detective Agency,1,8,0,9
524,Rugal,0,1,0,1
525,Arthdal Chronicles,0,1,0,1
526,Ice Fantasy,0,1,0,1
527,DreamWorks How to Train Your Dragon Legends,0,1,0,1
528,If I Hadn't Met You,0,2,0,2
529,Angel's Last Mission: Love,0,1,0,1
530,Osmosis,2,2,0,4
531,Omniscient,1,1,1,3
532,The Innocents,1,3,0,4
533,The Untamed,0,1,0,1
534,365 Days,1,0,0,1
535,Ocean's 8,0,1,0,1
536,The Equalizer 2,0,1,0,1
537,Hands of Stone,0,1,0,1
538,Hotel Transylvania 3: Summer Vacation,0,0,1,1
539,The SpongeBob Movie: Sponge Out of Water,0,1,0,1
540,Harry Potter and the Sorcerer's Stone,0,1,0,1
541,Matilda,0,1,0,1
542,The Kissing Booth,0,1,0,1
543,Parker,0,1,0,1
544,Despicable Me 2,0,2,0,2
545,Mowgli: Legend of the Jungle,0,1,0,1
546,The Angry Birds Movie,0,2,0,2
547,"Lord, Give Me Patience",0,1,0,1
548,Charlie and the Chocolate Factory,0,1,0,1
549,The Last Days of American Crime,0,1,0,1
550,Hotel Transylvania 2,0,0,1,1
551,Airplane Mode,0,2,0,2
552,Spenser Confidential,0,1,0,1
553,Tall Girl,0,0,1,1
554,Los Futbolísimos,0,1,0,1
555,"I love you, stupid",1,0,0,1
556,Murder Mystery,0,1,0,1
557,Alvin and the Chipmunks: The Road Chip,0,1,0,1
558,The Boy Who Harnessed the Wind,1,0,0,1
559,Tad the Lost Explorer and the Secret of King Midas (English Version),0,2,0,2
560,A Remarkable Tale,1,0,0,1
561,Despicable Me,0,2,0,2
562,Peter Rabbit,0,1,0,1
563,Bird Box,1,0,0,1
564,The Karate Kid,0,1,0,1
565,Madagascar,0,2,0,2
566,Miracle in Cell No. 7,0,1,0,1
567,The Willoughbys,0,3,0,3
568,Toc Toc,0,1,0,1
569,Rampage,0,1,0,1
570,Triple Frontier,0,0,1,1
571,Barbie Dolphin Magic,0,1,0,1
572,Harry Potter and the Chamber of Secrets,0,1,0,1
573,The Irishman,0,1,0,1
574,Furious 7,0,1,0,1
575,Da 5 Bloods,0,1,0,1
576,Flu,1,0,0,1
577,The Tribe,0,1,0,1
578,Pokémon: Mewtwo Strikes Back - Evolution,0,2,0,2
579,Shrek Forever After,0,1,0,1
580,Despite Everything,1,0,0,1
581,Madagascar 3: Europe's Most Wanted,0,3,0,3
582,To All the Boys: P.S. I Still Love You,0,1,0,1
583,Grown Ups 2,0,1,0,1
584,Bright,0,1,0,1
585,The Smurfs 2,0,1,0,1
586,The Legacy of the Bones,0,1,0,1
587,The Equalizer,0,1,0,1
588,Warcraft,0,1,0,1
589,300: Rise of an Empire,0,1,0,1
590,Leave No Trace,1,0,0,1
591,Ready Player One,0,1,0,1
592,Get Rich or Die Tryin',0,1,0,1
593,For Your Own Good,0,1,0,1
594,Dennis the Menace,0,1,0,1
595,The Invisible Guardian,0,1,0,1
596,The Revenant,0,1,0,1
597,The Princess Switch,0,1,0,1
598,Code 8,0,1,0,1
599,The Two Popes,0,1,0,1
600,Falling Inn Love,0,1,0,1
601,The Perfect Date,0,1,0,1
602,Daddy Day Care,0,1,0,1
603,The Platform,0,1,0,1
604,The Invisible Guest,0,1,0,1
605,Oldboy,0,1,0,1
606,The Occupant,0,1,1,2
607,The Silence,0,1,0,1
608,A Simple Favor,0,1,0,1
609,Fractured,0,1,0,1
610,El cuerpo,0,1,0,1
611,Dangerous Lies,0,1,0,1
612,A Fall from Grace,0,1,0,1
613,Gone Girl,0,1,0,1
614,In the Tall Grass,0,1,0,1
615,Mirage,0,1,0,1
616,The General's Daughter,0,1,0,1
617,The Shining,0,1,0,1
618,El Camino: A Breaking Bad Movie,0,1,0,1
619,Uncut Gems,0,2,0,2
620,In the Shadow of the Moon,0,1,0,1
621,I Am Mother,0,1,0,1
622,The Kill Team,0,1,0,1
623,The Bar,0,0,1,1
624,Zodiac,0,1,0,1
625,Marrowbone,0,1,0,1
626,Your Son,0,1,0,1
627,The Silence of the Marsh,0,1,0,1
628,Operation Finale,0,1,0,1
629,The Da Vinci Code,0,1,0,1
630,Cell 211,0,1,0,1
631,The Departed,0,1,0,1
632,The Wolf's Call,0,1,0,1
633,22 July,0,1,0,1
634,The Warning,0,1,0,1
635,1922,0,1,0,1
636,Secret Obsession,0,1,0,1
637,Intuition,0,1,0,1
638,Sara's Notebook,0,1,0,1
639,May God Forgive Us,0,1,0,1
640,Gerald's Game,0,1,0,1
641,Along Came a Spider,0,1,0,1
642,Sleep Tight,0,1,0,1
643,Gun City,0,1,0,1
644,The Next Three Days,0,1,0,1
645,Limitless,0,1,0,1
646,Mystic River,0,1,0,1
647,Mark of the Devil,0,1,0,1
648,Shot Caller,0,1,0,1
649,The Skin I Live In,0,1,0,1
650,A Walk Among the Tombstones,0,1,0,1
651,The Last Thing He Wanted,1,0,0,1
652,Captain Phillips,0,1,0,1
653,True Story,0,1,0,1
654,Side Effects,0,1,0,1
655,Red Dragon,0,1,0,1
656,Circle,0,2,0,2
657,Rattlesnake,0,1,0,1
658,The Invitation,1,0,0,1
659,The Perfection,0,1,0,1
660,Perdida,0,1,0,1
661,Jaws 2,0,1,0,1
662,Fracture,0,1,0,1
663,Taking Lives,0,0,1,1
664,Dorian Gray,0,1,0,1
665,The Hateful Eight,0,1,0,1
666,Earth and Blood,0,1,0,1
667,Jaws: The Revenge,0,1,0,1
668,To Steal from a Thief,0,1,0,1
669,Toro,0,1,0,1
670,Gravity,0,1,0,1
671,Primal Fear,0,1,0,1
672,Jack the Giant Slayer,0,1,0,1
673,To All the Boys I’ve Loved Before,1,0,0,1
674,The Wrong Missy,0,1,0,1
675,Isn't It Romantic,0,1,0,1
676,Perdona si te llamo amor,0,1,0,1
677,The Tree of Blood,0,1,0,1
678,Newness,0,1,0,1
679,Spanish Affair,0,1,0,1
680,She's Out of My League,0,1,0,1
681,Rich in Love,1,1,0,2
682,The Notebook,0,1,0,1
683,Your Name,0,1,0,1
684,The Half Of It,1,0,0,1
685,Hall Pass,0,2,0,2
686,The Last Summer,0,1,0,1
687,Eat Pray Love,0,1,0,1
688,Amar,0,1,0,1
689,Blended,0,1,0,1
690,Mamma Mia!,1,0,0,1
691,Friends with Benefits,0,1,0,1
692,All The Bright Places,0,1,0,1
693,The Lake House,0,1,0,1
694,The Lucky One,0,1,0,1
695,The Best of Me,0,1,0,1
696,"Kiki, Love to Love",0,1,0,1
697,The Theory of Everything,0,1,0,1
698,Below Her Mouth,1,0,0,1
699,Forrest Gump,0,1,0,1
700,Spanish Affair 2,0,1,0,1
701,Clueless,1,0,0,1
702,Dirty Dancing,0,1,0,1
703,Let's Dance,0,1,0,1
704,A Cinderella Story: Christmas Wish,1,0,0,1
705,The Remains of the Day,0,1,0,1
706,Safe Haven,0,1,0,1
707,Battle,1,0,0,1
708,Palm Trees in the Snow,0,1,0,1
709,Burlesque,0,1,0,1
710,Up in the Air,0,1,0,1
711,The Young Victoria,0,1,0,1
712,"Crazy, Stupid, Love",0,2,0,2
713,Sierra Burgess Is a Loser,0,1,0,1
714,Aloha,0,1,0,1
715,Flipped,0,1,0,1
716,Love Wedding Repeat,0,1,0,1
717,Seven Pounds,0,1,0,1
718,Ibiza,0,1,0,1
719,Naked,0,1,0,1
720,Bridget Jones's Baby,1,0,0,1
721,Coming to America,0,1,0,1
722,A Christmas Prince: The Royal Baby,0,1,0,1
723,Dear John,0,1,0,1
724,Blue Lagoon: The Awakening,0,1,0,1
725,Breakfast at Tiffany's,0,1,0,1
726,The Lovebirds,0,1,0,1
727,Two Weeks Notice,0,1,0,1
728,The Ugly Truth,0,1,0,1
729,Holiday in the Wild,0,1,0,1
730,Beautiful Creatures,0,1,0,1
731,Yes Man,1,0,0,1
732,Irreplaceable You,1,0,0,1
733,Extraction,0,1,0,1
734,Magnetic,1,1,0,2
735,Pixels,0,1,0,1
736,The Amazing Spider-Man,0,1,0,1
737,American Sniper,0,1,0,1
738,Iron Man,0,1,0,1
739,Overlord,0,1,0,1
740,Journey 2: The Mysterious Island,0,1,0,1
741,Boyka: Undisputed,0,1,0,1
742,Dragon Ball Z: Battle of Gods,0,1,0,1
743,Homefront,0,1,0,1
744,The Fast and the Furious,0,1,0,1
745,Inferno,0,1,0,1
746,The Lord of the Rings: The Fellowship of the Ring,0,1,0,1
747,Mission: Impossible - Fallout,0,1,0,1
748,300,0,1,0,1
749,Fast Five,0,1,0,1
750,Assassin's Creed,0,1,0,1
751,Superfly,0,1,0,1
752,Sausage Party,0,2,0,2
753,Jurassic Park,0,1,0,1
754,The Dark Knight,0,1,0,1
755,Colombiana,0,1,0,1
756,Harry Potter and the Deathly Hallows: Part 1,0,1,0,1
757,Shaft,0,1,0,1
758,How It Ends,0,1,0,1
759,The Purge: Anarchy,0,1,0,1
760,The Purge: Election Year,0,1,0,1
761,THE MECHANIC,0,1,0,1
762,Unbroken,1,0,0,1
763,Heroes Wanted,0,1,0,1
764,The Expendables 3,0,1,0,1
765,Rim of the World,0,1,0,1
766,The Lord of the Rings: The Two Towers,0,1,0,1
767,The Matrix,3,0,0,3
768,Ghostbusters,0,1,0,1
769,Rogue Assassin,0,1,0,1
770,Bad Boys II,0,1,0,1
771,Ocean's Eleven,0,1,0,1
772,Extinction,0,1,0,1
773,Acts of Vengeance,0,1,0,1
774,The Island,0,4,0,4
775,Burn Out,0,1,0,1
776,The Book of Eli,0,2,0,2
777,Inception,0,1,0,1
778,Transformers: Age of Extinction,0,1,0,1
779,Shooter,2,8,0,10
780,The Lord of the Rings: The Return of the King,0,1,0,1
781,Snitch,0,1,0,1
782,The Losers,0,1,0,1
783,Harry Potter and the Prisoner of Azkaban,0,1,0,1
784,DJ Cinderella,0,1,0,1
785,The Little Mermaid,0,2,0,2
786,The Smurfs,0,1,0,1
787,Madagascar: Escape 2 Africa,0,2,0,2
788,Spirited Away,0,1,0,1
789,Space Jam,0,1,0,1
790,The Main Event,0,1,0,1
791,Monster House,0,1,0,1
792,Harry Potter and the Goblet of Fire,0,1,0,1
793,The House with a Clock in Its Walls,1,0,0,1
794,Full Out,0,1,0,1
795,Annie,0,1,0,1
796,Klaus,0,1,0,1
797,Happy Feet,0,1,0,1
798,3 Ninjas: Kick Back,0,1,0,1
799,Pan,0,1,0,1
800,Imagine That,1,0,0,1
801,A Little Princess,0,1,0,1
802,Howl’s Moving Castle,0,1,0,1
803,Tad: The Lost Explorer,0,1,0,1
804,Miracles from Heaven,1,0,0,1
805,Trolls Holiday Special,0,1,0,1
806,Stuart Little,0,1,0,1
807,Benji,0,1,0,1
808,The Flintstones,0,1,0,1
809,The Witches,0,1,0,1
810,Harry Potter and the Order of the Phoenix,0,1,0,1
811,Free Willy,0,1,0,1
812,Rise of the Guardians,0,1,0,1
813,Mirror Mirror,0,1,0,1
814,A Cinderella Story,0,1,0,1
815,Shark Tale,1,2,0,3
816,Kung Fu Panda 2,1,0,0,1
817,Shrek the Third,0,2,0,2
818,Harry Potter and the Deathly Hallows: Part 2,0,1,0,1
819,Puss in Boots,0,1,0,1
820,Harry Potter and the Half-Blood Prince,0,1,0,1
821,My Neighbor Totoro,0,1,0,1
822,Kung Fu Panda,0,2,0,2
823,How to Train Your Dragon,0,1,0,1
824,The NeverEnding Story,0,1,0,1
825,Middle School: The Worst Years of My Life,0,1,0,1
826,The Fast and the Furious: Tokyo Drift,0,1,0,1
827,Polar,0,1,0,1
828,Ocean's Thirteen,0,1,0,1
829,Bullet to the Head,0,1,0,1
830,Ocean's Twelve,0,1,0,1
831,Falcon Rising,0,1,0,1
832,Sicario: Day of the Soldado,0,1,0,1
833,2 Fast 2 Furious,0,1,0,1
834,Escape from Alcatraz,0,1,0,1
835,Inside Man,0,1,0,1
836,Takers,0,1,0,1
837,Hold the Dark,0,1,0,1
838,Repo Men,0,1,0,1
839,Sherlock Holmes,0,1,0,1
840,Proud Mary,0,1,0,1
841,The Dark Knight Rises,0,1,0,1
842,Blade Runner: The Final Cut,0,1,0,1
843,Sherlock Holmes: A Game of Shadows,0,1,0,1
844,The Hard Way,0,1,0,1
845,Dead Man Down,0,1,0,1
846,Point Blank,0,1,0,1
847,The Family,0,1,0,1
848,The Other Guys,0,1,0,1
849,Maximum Risk,0,1,0,1
850,Point Break,0,1,0,1
851,The Tourist,0,1,0,1
852,Kill Bill: Vol. 1,0,1,0,1
853,Savage Dog,0,1,0,1
854,A Man Apart,0,0,1,1
855,Paradise Beach,0,1,0,1
856,The Punisher,5,15,0,20
857,Unknown,0,1,0,1
858,The Bourne Identity,0,1,0,1
859,The Taking of Pelham 123,0,1,0,1
860,22 Bullets,0,1,0,1
861,The Bourne Supremacy,0,1,0,1
862,Drive,0,1,0,1
863,Taxi 4,0,1,0,1
864,Beyond Skyline,0,1,0,1
865,The Chronicles of Riddick,0,1,0,1
866,Taxi 2,0,1,0,1
867,The Warriors,0,1,0,1
868,The Night Comes for Us,0,1,0,1
869,The Nice Guys,0,1,0,1
870,Pain and Glory,0,1,0,1
871,In Family I Trust,1,0,0,1
872,Perfect Strangers,0,0,1,1
873,8 Mile,0,1,0,1
874,Seventeen,0,1,0,1
875,The Photographer Of Mauthausen,1,0,0,1
876,Marriage Story,0,1,0,1
877,"Extremely Wicked, Shockingly Evil and Vile",0,1,0,1
878,"Live Twice, Love Once",1,0,0,1
879,The Endless Trench,0,3,0,3
880,The Song of Names,0,1,0,1
881,The Impossible,0,0,1,1
882,Go Karts,0,1,0,1
883,Lost Girls,1,0,0,1
884,The Big Short,0,1,0,1
885,Growing up and other problems,0,2,0,2
886,4L,0,1,0,1
887,Catch Me If You Can,0,1,0,1
888,The King,0,1,0,1
889,Holy Camp!,0,3,0,3
890,Villaviciosa,0,1,0,1
891,White Chicks,0,1,0,1
892,Thi Mai,1,0,0,1
893,Daddy's Home,0,1,0,1
894,Game Night,0,2,0,2
895,Ted,0,1,0,1
896,Dragon Ball Z: Resurrection 'F',0,1,0,1
897,A Quiet Place,0,1,0,1
898,A Silent Voice,1,0,0,1
899,Princess Mononoke,0,1,0,1
900,The Godfather,0,1,0,1
901,The Imitation Game,0,1,0,1
902,Coach Carter,0,1,0,1
903,Capture the Flag,0,1,0,1
904,GoodFellas,0,1,0,1
905,The Hangover,0,1,0,1
906,Ponyo,0,1,0,1
907,Paddington,0,1,0,1
908,Apollo 13,0,1,0,1
909,A Monster Calls,0,0,1,1
910,The Danish Girl,0,1,0,1
911,The Witch,0,1,0,1
912,Pulp Fiction,0,1,0,1
913,Ip Man 2,0,1,0,1
914,A Beautiful Mind,0,1,0,1
915,Icarus,0,1,0,1
916,Megamind,0,1,0,1
917,Next Gen,0,2,0,2
918,My Little Pony: Equestria Girls,0,1,0,1
919,Jumanji,0,1,0,1
920,Journey to the Center of the Earth,0,1,0,1
921,Kiki’s Delivery Service,0,1,0,1
922,My Little Pony Equestria Girls: Friendship Games,0,2,0,2
923,Castle in the Sky,0,1,0,1
924,Ghostbusters 2,0,1,0,1
925,DreamWorks Shrek the Halls,0,1,0,1
926,Dragons: Dawn of the Dragon Racers,1,1,0,2
927,Super Monsters Furever Friends,0,0,0,0
928,The Cat Returns,0,1,0,1
929,The Tale of The Princess Kaguya,0,1,0,1
930,Dragons: Rescue Riders: Hunt for the Golden Dragon,0,1,1,2
931,Nausicaä of the Valley of the Wind,0,1,0,1
932,Arrietty,0,1,0,1
933,NiNoKuni,0,1,0,1
934,48 Christmas Wishes,0,2,0,2
935,Super Monsters Back to School,0,0,0,0
936,Super Monsters: Vida's First Halloween,0,0,0,0
937,Super Monsters Save Halloween,0,0,0,0
938,All Hallows' Eve,0,1,0,1
939,Wicked Flying Monkeys,0,1,0,1
940,Modest Heroes: Ponoc Short Films Theatre,0,3,0,3
941,Albion: The Enchanted Stallion,1,0,0,1
942,Super Monsters and the Wish Star,0,1,0,1
943,Invader Zim: Enter the Florpus,0,3,0,3
944,A Witches' Ball,0,1,0,1
945,F.R.E.D.I.,0,1,0,1
946,Bob's Broken Sleigh,0,1,0,1
947,The Wishing Tree,1,0,0,1
948,Man of Steel,0,1,0,1
949,The Seven Deadly Sins the Movie: Prisoners of the Sky,0,2,0,2
950,Dracula Untold,0,1,0,1
951,The 5th Wave,0,1,0,1
952,The Incredible Hulk,0,1,0,1
953,Green Lantern,0,1,0,1
954,Spectral,0,1,0,1
955,Deep Blue Sea,0,1,0,1
956,Conan the Barbarian,0,1,0,1
957,Godzilla,0,1,0,1
958,Jurassic Park III,0,1,0,1
959,The Mummy,0,1,0,1
960,The Lost World: Jurassic Park,0,1,0,1
961,The Mortal Instruments: City of Bones,0,1,0,1
962,Legion,1,6,0,7
963,Waterworld,0,1,0,1
964,The Forbidden Kingdom,0,1,0,1
965,Jupiter Ascending,3,0,0,3
966,Solomon Kane,0,0,1,1
967,The Matrix Reloaded,3,0,0,3
968,The Covenant,0,1,0,1
969,The Mummy Returns,0,1,0,1
970,The Cloverfield Paradox,0,1,0,1
971,Priest,0,1,0,1
972,Battle: Los Angeles,0,1,0,1
973,Resident Evil: Afterlife,0,1,0,1
974,Children of Men,0,1,0,1
975,Alien Warfare,0,1,0,1
976,The Mummy: Tomb of the Dragon Emperor,0,1,0,1
977,The Scorpion King,0,1,0,1
978,"I, Frankenstein",0,1,0,1
979,Bleach,0,1,0,1
980,GANTZ:O,0,1,0,1
981,Underworld: Rise of the Lycans,0,1,0,1
982,Sword Art Online the Movie: Ordinal Scale,0,1,0,1
983,Watchmen,0,1,0,1
984,The End of Evangelion,0,2,0,2
985,Revolt,0,1,0,1
986,Eli,0,0,1,1
987,The Influence,0,1,0,1
988,The Decline,0,1,0,1
989,GO! The Unforgettable Party,0,1,0,1
990,Back of the Net,1,0,0,1
991,The Highwaymen,0,1,0,1
992,Travis Scott: Look Mom I Can Fly,0,2,0,2
993,Captain Underpants Epic Choice-o-Rama,0,1,0,1
994,The Laundromat,0,1,0,1
995,Becoming,1,0,0,1
996,18 Presents,0,1,0,1
997,The Little Switzerland,0,1,0,1
998,Rock My Heart,0,1,0,1
999,Wounds,0,1,0,1
1000,"Oh, Ramona!",1,0,0,1
1001,Walk. Ride. Rodeo.,0,1,0,1
1002,Mujeres arriba,0,1,0,1
1003,"¡Ay, mi madre!",0,1,0,1
1004,Veronica,0,1,0,1
1005,Annabelle,0,1,0,1
1006,Ouija,0,1,0,1
1007,Don't Breathe,0,1,0,1
1008,A Nightmare on Elm Street,0,1,0,1
1009,Friday the 13th,0,1,0,1
1010,Deliver Us from Evil,0,1,0,1
1011,Annihilation,0,1,0,1
1012,The Ruins,0,1,0,1
1013,Insidious,0,1,0,1
1014,The Babysitter,0,1,0,1
1015,Day of the Dead: Bloodline,0,0,1,1
1016,Scary Movie,0,1,0,1
1017,The Ritual,0,1,0,1
1018,Hush,0,1,0,1
1019,Insidious 2,0,1,0,1
1020,Fragile,0,1,0,1
1021,Death Note,0,1,0,1
1022,Scouts Guide to the Zombie Apocalypse,0,1,0,1
1023,Anacondas: The Hunt for the Blood Orchid,0,1,0,1
1024,Sinister,0,1,0,1
1025,The Open House,1,1,0,2
1026,Insidious: Chapter 3,0,1,0,1
1027,Malevolent,0,1,0,1
1028,Cargo,1,1,0,2
1029,The Rite,0,1,0,1
1030,The Exorcism of Emily Rose,0,1,0,1
1031,Let Me In,0,1,0,1
1032,Scary Movie 2,0,1,0,1
1033,Sinister Circle,0,1,0,1
1034,Dark Shadows,0,1,0,1
1035,Final Destination 5,0,1,0,1
1036,[Rec] 3: Genesis,0,1,0,1
1037,Sinister 2,0,0,1,1
1038,Scary Movie 3,0,1,0,1
1039,Ghost Ship,0,1,0,1
1040,The Woman in Black,0,1,0,1
1041,Little Evil,1,0,0,1
1042,[REC],0,2,0,2
1043,Paranormal Activity 4,0,2,0,2
1044,Cam,0,1,0,1
1045,Apostle,0,1,0,1
1046,[Rec] 4: Apocalypse,0,1,0,1
1047,Second Name,0,1,0,1
1048,Aterrados,0,0,1,1
1049,Errementari: The Blacksmith and the Devil,0,1,0,1
1050,The Darkness,0,1,0,1
1051,Camarón: The Film,0,1,0,1
1052,OT: la película,0,2,0,2
1053,Countdown to Death: Pablo Escobar,0,2,0,2
1054,Michael Jackson's This Is It,0,1,0,1
1055,"El Pepe, a Supreme Life",0,1,0,1
1056,The Game Changers,0,1,0,1
1057,Lil Peep: Everybody’s Everything,0,2,0,2
1058,Alejandro Sanz: What I Was Is What I Am,1,2,1,4
1059,I Am Ali,1,0,0,1
1060,Dancing with the Birds,0,1,0,1
1061,Minimalism: A Documentary About the Important Things,0,1,0,1
1062,Don't Crack Under Pressure,0,1,0,1
1063,Whitney: Can I Be Me,0,2,0,2
1064,The Dawn Wall,0,2,0,2
1065,Barça Dreams,0,1,0,1
1066,The Carter Effect,0,1,0,1
1067,The Great Hack,1,1,0,2
1068,"Alias JJ, la celebridad del mal",0,0,0,0
1069,Diana: In Her Own Words,0,1,0,1
1070,Parchís: the Documentary,0,1,0,1
1071,The Redeemed and the Dominant: Fittest on Earth,1,2,0,3
1072,Miss Americana,1,0,0,1
1073,Ronnie Coleman: The King,0,1,0,1
1074,The Rolling Stones: Olé Olé Olé! A Trip Across Latin America,0,1,0,1
1075,Rocco,0,2,0,2
1076,Jago: A Life Underwater,0,2,0,2
1077,Tony Robbins: I Am Not Your Guru,0,1,0,1
1078,Have a Good Trip: Adventures in Psychedelics,0,1,0,1
1079,Antoine Griezmann: The Making of a Legend,0,1,0,1
1080,Don't Crack Under Pressure III,0,1,0,1
1081,Hot Girls Wanted,2,0,0,2
1082,One of Us,2,0,0,2
1083,Miles Davis: Birth of the Cool,0,1,0,1
1084,What the Health,0,2,0,2
1085,Chasing Coral,0,1,0,1
1086,NOVA: Black Hole Apocalypse,0,1,0,1
1087,Perú: Tesoro escondido,0,1,0,1
1088,The Secret,0,1,0,1
1089,Sad Hill Unearthed,0,1,0,1
1090,Cuba and the Cameraman,0,1,0,1
1091,Cowspiracy: The Sustainability Secret,0,2,0,2
1092,Nazi Concentration Camps,0,1,0,1
1093,El Che,0,0,1,1
1094,100 Days of Solitude,0,2,0,2
1095,Unacknowledged,0,1,0,1
1096,Heal,1,0,0,1
1097,Jane,0,1,0,1
1098,Abducted in Plain Sight,1,0,0,1
1099,Jiro Dreams of Sushi,0,1,0,1
1100,Murder to Mercy: The Cyntoia Brown Story,0,1,0,1
1101,HOMECOMING: A film by Beyoncé,0,0,1,1
1102,The 24 Hour War,0,2,0,2
1103,Bethany Hamilton: Unstoppable,0,1,0,1
1104,Don't Crack Under Pressure II,0,1,0,1
1105,Zion,0,1,0,1
1106,Mountain,0,1,0,1
1107,ReMastered: Devil at the Crossroads,0,1,0,1
1108,Keith Richards: Under the Influence,0,1,0,1
1109,National Parks Adventure,0,1,0,1
1110,"Bikram: Yogi, Guru, Predator",1,0,0,1
1111,Gaga: Five Foot Two,0,1,0,1
1112,A Life of Speed: The Juan Manuel Fangio Story,0,1,0,1
1113,American Factory,1,1,0,2
1114,ReMastered: Who Shot the Sheriff,0,1,0,1
1115,APEX: The Story of the Hypercar,0,1,1,2
1116,The Death and Life of Marsha P. Johnson,0,1,0,1
1117,Project X,0,1,0,1
1118,Puss in Book: Trapped in an Epic Tale,0,2,0,2
1119,Dumb and Dumber,0,2,0,2
1120,Show Dogs,0,1,0,1
1121,Looney Tunes: Back in Action,0,1,0,1
1122,Good Burger,0,1,0,1
1123,Naked Gun 33 1/3: The Final Insult,0,1,0,1
1124,Get Hard,0,1,0,1
1125,Hotel for Dogs,0,1,0,1
1126,The Spy Who Dumped Me,1,0,0,1
1127,The Ridiculous 6,0,1,0,1
1128,The Package,0,1,0,1
1129,Look Who's Talking,1,0,0,1
1130,Pants on Fire,0,1,0,1
1131,Big Stan,0,1,0,1
1132,Rey Gitano,0,1,0,1
1133,Jack and Jill,0,1,0,1
1134,Year One,0,1,0,1
1135,Dumb and Dumberer: When Harry Met Lloyd,0,1,0,1
1136,Flushed Away,0,2,0,2
1137,"See No Evil, Hear No Evil",0,1,0,1
1138,Jackass: The Movie,0,1,0,1
1139,The Do-Over,0,1,0,1
1140,Death at a Funeral,0,1,0,1
1141,Swiped,1,0,0,1
1142,A Thousand Words,0,1,0,1
1143,Just Friends,0,1,0,1
1144,Mission: Impossible - Rogue Nation,0,1,0,1
1145,Marcella (Serie de TV),1,8,0,9
1146,4th Republic,0,1,0,1
1147,F Is for Family (Serie de TV),0,7,0,7
1148,Viajes Pokémon: La Serie (Serie de TV),1,1,0,2
1149,Historia de un crimen: La búsqueda (Serie de TV),2,1,0,3
1150,Kipo y la era de los magnimales (Serie de TV),0,2,0,2
1151,Bosque adentro (Miniserie de TV),0,2,0,2
1152,Addicted to Life ,0,1,0,1
1153,Nuit de la Glisse: Magnetismo ,0,1,0,1
1154,Don't Crack Under Pressure - Season Three ,0,1,0,1
1155,Jo Koy: In His Elements (TV),0,0,0,0
1156,Whispers (Serie de TV),1,0,0,1
1157,Curon (Serie de TV),1,5,0,6
1158,Lenox Hill (Serie de TV),1,1,0,2
1159,Overlord ,0,1,0,1
1160,Por trece razones: La temporada final (Serie de TV),0,4,0,4
1161,Perdida (Serie de TV),0,4,0,4
1162,No dejes rastro ,1,0,0,1
1163,La extraña fuente de la fortuna ,0,1,0,1
1164,SuperFly ,0,1,0,1
1165,Merry Men 2,0,1,0,1
1166,Baki (Serie de TV),0,2,0,2
1167,Hospital Playlist (Serie de TV),0,1,0,1
1168,¿Me oyes? (Serie de TV),2,1,0,3
1169,Spelling the Dream ,0,1,0,1
1170,Madres forzosas (Serie de TV),2,9,0,11
1171,Vera: el arcoiris sin fin (TV),0,0,0,0
1172,The Invincible Dragon ,1,0,0,1
1173,El árbol de la sangre ,0,1,0,1
1174,44 Gatos (Serie de TV),0,1,0,1
1175,Cook Off ,0,1,0,1
1176,Space Force (Serie de TV),0,4,0,4
1177,Comida para Phil (Serie de TV),0,1,0,1
1178,La corazonada ,0,1,0,1
1179,Dorohedoro (Serie de TV),0,1,0,1
1180,Jeffrey Epstein: Asquerosamente rico (Miniserie de TV),1,0,0,1
1181,Ya no estoy aquí ,0,1,0,1
1182,Hannah Gadsby: Douglas (TV),1,0,0,1
1183,Snowpiercer: Rompenieves (Serie de TV),1,5,0,6
1184,Betaal (Miniserie de TV),1,2,0,3
1185,Dinastía (Serie de TV),1,2,0,3
1186,Control Z (Serie de TV),0,2,0,2
1187,¡Vaya historia! (Serie de TV),1,0,0,1
1188,Trailer Park Boys: The Animated Series (Serie de TV),0,4,0,4
1189,Sleepless Society: Dos almohadas y un alma perdida (Serie de TV),0,0,0,0
1190,La reina de Indias y el conquistador (Serie de TV),0,3,0,3
1191,Blood & Water (Serie de TV),2,1,0,3
1192,Ben Platt: Live from Radio City Music Hall (TV),0,2,0,2
1193,Rebelión de los Godínez ,0,1,0,1
1194,Dulces magnolias (Serie de TV),2,1,0,3
1195,Patton Oswalt: I Love Everything (TV),0,1,0,1
1196,White Lines (Serie de TV),1,2,1,4
1197,La canción de los nombres olvidados ,0,1,0,1
1198,Chichipatos (Serie de TV),0,2,0,2
1199,"Te quiero, imbécil ",1,0,0,1
1200,Human Nature ,0,1,0,1
1201,Blanche comme neige ,1,0,0,1
1202,She-Ra y las princesas del poder (Serie de TV),7,4,0,11
1203,Recursos inhumanos (Miniserie de TV),0,1,0,1
1204,Empezar de nuevo ,0,1,0,1
1205,Rencor tatuado ,0,0,1,1
1206,La otra Missy ,0,1,0,1
1207,Unbreakable Kimmy Schmidt: Kimmy vs the Reverend (TV),1,0,0,1
1208,Vera: Cuentos fantásticos (Serie de TV),1,4,0,5
1209,Juicios mediáticos (Serie de TV),2,4,0,6
1210,Buen viaje: Aventuras psicodélicas ,0,1,0,1
1211,The Eddy (Miniserie de TV),1,4,1,6
1212,Chico Bun Bun: Un mono manitas (Serie de TV),0,0,0,0
1213,18 regalos,0,1,0,1
1214,Muertos para mí (Serie de TV),4,1,0,5
1215,Valeria (Serie de TV),3,0,0,3
1216,Hotel Transilvania 3: Unas vacaciones monstruosas,0,0,1,1
1217,Scissor Seven (Serie de TV),0,1,0,1
1218,"De tonta, nada ",0,1,0,1
1219,Madres trabajadoras (Serie de TV),6,2,0,8
1220,Mi historia ,1,0,0,1
1221,Jerry Seinfeld: 23 Hours to Kill,0,1,0,1
1222,"No andaba muerto, estaba de parranda ",0,1,0,1
1223,Hollywood (Miniserie de TV),3,5,0,8
1224,Conquista a medias ,1,0,0,1
1225,Furia ,0,1,0,1
1226,Todo el día y una noche ,0,1,0,1
1227,Animales sin collar ,0,1,0,1
1228,La sombra de la ley ,0,1,0,1
1229,Apuntes para una película de atracos ,0,0,1,1
1230,Casi feliz (Serie de TV),0,0,1,1
1231,Mrs. Serial Killer ,0,1,0,1
1232,Ricos de amor ,1,1,0,2
1233,Dangerous Lies ,0,1,0,1
1234,The Forest of Love: Deep Cut (Serie de TV),0,1,0,1
1235,Drifting Dragons (Serie de TV),0,1,0,1
1236,The Victims' Game (Serie de TV),0,0,0,0
1237,A tres metros sobre el cielo: La serie (Serie de TV),0,2,0,2
1238,Extracurricular (Serie de TV),1,0,0,1
1239,A Secret Love ,0,1,0,1
1240,Crimen y perdón: La historia de Cyntoia Brown ,0,1,0,1
1241,¡Tú la llevas! ,0,1,0,1
1242,Yo nunca (Serie de TV),1,3,0,4
1243,The Last Kingdom (Serie de TV),0,13,0,13
1244,"El coronavirus, en pocas palabras (Miniserie de TV)",1,0,0,1
1245,"Hi Bye, Mama! (Serie de TV)",0,1,0,1
1246,Tyler Rake ,0,1,0,1
1247,After Life (Serie de TV),0,2,0,2
1248,Amor 101 (Serie de TV),0,2,0,2
1249,"Hola, ninja (Serie de TV)",0,1,0,1
1250,Ghost in the Shell: SAC_2045 (Serie de TV),0,2,0,2
1251,La casa de las flores (Serie de TV),0,5,1,6
1252,Tiempo de caza ,0,1,0,1
1253,El silencio del pantano ,0,1,0,1
1254,Las plagas de Breslavia ,0,1,0,1
1255,Un planeta absurdo (Serie de TV),0,0,0,0
1256,Circus of Books ,1,0,0,1
1257,Middleditch & Schwartz (Serie de TV),0,2,0,2
1258,The Midnight Gospel (Serie de TV),0,2,0,2
1259,El último baile (Miniserie de TV),0,1,0,1
1260,Sicario: El día del soldado ,0,1,0,1
1261,Sergio ,0,1,0,1
1262,Fiebre del ladrillo ,0,1,0,1
1263,Legado en los huesos ,0,1,0,1
1264,Código 8,0,1,0,1
1265,La tierra y la sangre ,0,1,0,1
1266,#blackAF (Serie de TV),1,0,0,1
1267,El dragón: El regreso de un guerrero (Serie de TV),0,3,0,3
1268,Hasmukh (Miniserie de TV),0,1,0,1
1269,Hyena (Serie de TV),0,1,0,1
1270,Los últimos frikis del mundo (Serie de TV),0,1,0,1
1271,Fauda (Serie de TV),0,4,0,4
1272,Fary: Hexagone (Serie de TV),0,0,0,0
1273,Mauricio Meirelles: Levando o Caos ,0,1,0,1
1274,The Innocence Files (Serie de TV),2,4,0,6
1275,Outer Banks (Serie de TV),2,1,0,3
1276,Loving Vincent ,1,1,0,2
1277,Nueva vida en Nueva York ,0,1,0,1
1278,Josie ,0,1,0,1
1279,Hacerse mayor y otros problemas ,1,0,0,1
1280,Amor. Boda. Azar ,0,1,0,1
1281,Disobedience ,0,0,1,1
1282,Mi primer gran combate ,0,1,0,1
1283,Tigertail ,0,1,0,1
1284,Il processo (Serie de TV),0,2,0,2
1285,L.A. Originals ,0,1,0,1
1286,Hi Score Girl (Serie de TV),0,1,0,1
1287,El show de Big Show (Serie de TV),1,2,0,3
1288,Feliz año pasado ,0,1,0,1
1289,La casa de papel (Serie de TV),0,5,2,7
1290,La casa de papel: El fenómeno ,0,2,0,2
1291,El sol naciente (C),0,1,0,1
1292,Coffee & Kareem ,0,1,0,1
1293,Spirit Riding Free: Riding Academy (Serie de TV),0,0,0,0
1294,Centella (Serie de TV),0,0,0,0
1295,Violet Evergarden: La eternidad y la muñeca de recuerdos automáticos ,1,1,0,2
1296,How to Fix a Drug Scandal (Miniserie de TV),1,0,0,1
1297,Sunderland 'Til I Die (Serie de TV),1,8,0,9
1298,Ready Player One ,0,1,0,1
1299,The Iliza Shlesinger Sketch Show (Serie de TV),1,0,0,1
1300,David Batra: Elefanten i rummet ,0,2,0,2
1301,Bodies at Rest ,0,1,0,1
1302,Ozark (Serie de TV),3,8,0,11
1303,Itaewon Class (Serie de TV),0,3,0,3
1304,El declive ,0,1,0,1
1305,El sumiller ,0,1,0,1
1306,7 Seeds (Serie de TV),0,1,0,1
1307,Unorthodox (Miniserie de TV),3,0,0,3
1308,Black Lightning (Serie de TV),4,8,0,12
1309,Hogar ,0,1,1,2
1310,Campamento extraordinario ,1,1,0,2
1311,En la ciénaga (Serie de TV),0,2,0,2
1312,Tom Segura: Ball Hog (TV),0,1,0,1
1313,Freud (Miniserie de TV),0,1,0,1
1314,Un juego de caballeros (Miniserie de TV),1,1,0,2
1315,Curtiz ,0,1,0,1
1316,El hoyo ,0,1,0,1
1317,Hinchas radicales ,0,1,0,1
1318,Vampiros (Serie de TV),0,1,0,1
1319,She (Serie de TV),0,1,0,1
1320,Madam C. J. Walker - Una mujer hecha a sí misma (Miniserie de TV),0,2,0,2
1321,Sitara: Que las niñas sueñen por fin (C),1,0,0,1
1322,"Fangio, el hombre que domaba las máquinas ",0,1,0,1
1323,Carta al Rey (Serie de TV),0,4,0,4
1324,Tiger King (Miniserie de TV),1,1,0,2
1325,Cuentos del lago: Billy Brinco y los guardianes ,0,1,0,1
1326,Feel Good (Serie de TV),1,0,0,1
1327,Altered Carbon: Reenfundados ,0,0,1,1
1328,La oveja Shaun: Aventuras en Mossy Bottom (Serie de TV),0,1,0,1
1329,Kingdom (Serie de TV),1,1,0,2
1330,Masameer the Movie ,0,1,0,1
1331,Chicas perdidas ,1,0,0,1
1332,Élite (Serie de TV),1,4,1,6
1333,Beastars (Serie de TV),0,1,0,1
1334,Los asesinatos del Valhalla (Serie de TV),1,1,1,3
1335,Viaje sangriento (Serie de TV),0,3,0,3
1336,Dirty Money (Serie de TV),4,9,0,13
1337,Paradise Police (Serie de TV),1,5,0,6
1338,El príncipe dragón (Serie de TV),1,7,0,8
1339,Castlevania (Serie de TV),0,4,0,4
1340,On My Block (Serie de TV),1,2,0,3
1341,Violet y Finch ,0,1,0,1
1342,Queen Sono (Serie de TV),0,1,0,1
1343,Altered Carbon 2 (Serie de TV),2,2,1,5
1344,Followers (Serie de TV),0,1,0,1
1345,Pokémon. Mewtwo contraataca: Evolución ,0,2,0,2
1346,Esta mierda me supera (Serie de TV),0,1,0,1
1347,Pete Davidson: Alive From New York ,0,1,0,1
1348,Gentefied (Serie de TV),1,2,0,3
1349,Puerta 7 (Miniserie de TV),0,2,0,2
1350,Spectros (Serie de TV),0,1,0,1
1351,Isi & Ossi ,0,1,0,1
1352,Narcos: México (Serie de TV),1,6,1,8
1353,Escuela de cachorros (Serie de TV),1,2,0,3
1354,Dragon Quest: Your Story ,0,2,1,3
1355,A todos los chicos 2: P.D. Todavía te quiero,0,1,0,1
1356,Camino a Roma ,0,2,0,2
1357,Locke & Key (Serie de TV),2,5,0,7
1358,Horse Girl ,0,1,0,1
1359,Stronger ,0,1,0,1
1360,El farmaceútico (Miniserie de TV),1,1,0,2
1361,Diamantes en bruto ,0,2,0,2
1362,Luna Nera (Serie de TV),3,0,0,3
1363,37 Seconds,1,0,0,1
1364,Ragnarok (Serie de TV),0,3,0,3
1365,Diablero (Serie de TV),0,4,0,4
1366,No hables con extraños (Miniserie de TV),1,2,0,3
1367,La Tierra de noche (Miniserie de TV),0,1,0,1
1368,Las escalofriantes aventuras de Sabrina: Parte 3 (Serie de TV),1,6,0,7
1369,The Goop Lab (Serie de TV),0,0,0,0
1370,La facción octubre (Serie de TV),2,4,0,6
1371,La novia fantasma (Serie de TV),1,1,0,2
1372,Fortune Feimster: Sweet & Salty (TV),1,0,0,1
1373,Sex Education (Serie de TV),4,1,0,5
1374,Ares (Serie de TV),1,4,0,5
1375,A traición ,0,1,0,1
1376,NiNoKuni ,0,1,0,1
1377,Grace and Frankie (Serie de TV),8,18,0,26
1378,Giri/Haji: Deber/Deshonor (Serie de TV),0,3,0,3
1379,Mesías (Serie de TV),1,2,0,3
1380,El vecino (Serie de TV),3,5,1,9
1381,Ana (Serie de TV),3,1,0,4
1382,You (Serie de TV),9,7,0,16
1383,Perdidos en el espacio (Serie de TV),2,5,0,7
1384,The Witcher (Serie de TV),2,3,0,5
1385,"A los gatos, ni tocarlos: Un asesino en internet (Miniserie de TV)",0,1,0,1
1386,Leslie Jones: Time Machine (TV),0,1,1,2
1387,6 en la sombra,0,1,0,1
1388,El irlandés ,0,1,0,1
1389,The Crown (Serie de TV),0,5,0,5
1390,La música del terremoto ,0,1,0,1
1391,Klaus ,0,1,0,1
1392,The King ,0,1,0,1
1393,Hache (Miniserie de TV),1,2,0,3
1394,Atípico (Serie de TV),6,8,0,14
1395,Yo soy Dolemite ,0,1,0,1
1396,El método Kominsky (Serie de TV),1,4,0,5
1397,Diecisiete ,0,1,0,1
1398,La trinchera infinita ,0,3,0,3
1399,Jonas (TV),0,1,0,1
1400,Milagro en la celda 7,0,1,0,1
1401,"Roman J. Israel, Esq. ",0,1,0,1
1402,Everybody's Everything ,0,2,0,2
1403,Carmen Sandiego (Serie de TV),0,3,0,3
1404,Rétame (Serie de TV),5,2,0,7
1405,Greenhouse Academy (Serie de TV),0,2,0,2
1406,Los juicios de Gabriel Fernández (Miniserie de TV),0,1,0,1
1407,Mujeres de la noche (Serie de TV),0,2,0,2
1408,Califato (Serie de TV),0,3,0,3
1409,Thunder Road ,0,1,0,1
1410,El plan ,0,1,0,1
1411,The Farewell ,1,0,0,1
1412,Greed ,0,1,0,1
1413,Billions (Serie de TV),8,29,0,37
1414,Fahim ,0,1,0,1
1415,Día de lluvia en Nueva York ,0,1,0,1
1416,Súper águilas ,0,0,0,0
1417,El silencio de la ciudad blanca ,0,1,0,1
1418,El rey del hielo ,0,1,0,1
1419,La llamada de lo salvaje ,0,1,0,1
1420,Manhattan sin salida ,0,1,0,1
1421,Un verano inolvidable ,1,0,0,1
1422,Mi gran pequeña granja ,0,1,0,1
1423,El escándalo ,0,1,0,1
1424,Cuando tú quieras ,0,1,0,1
1425,Sinónimos ,0,1,0,1
1426,Volando juntos ,0,1,0,1
1427,Adults in the Room (Comportarse como adultos) ,0,0,1,1
1428,Malos tiempos en El Royale ,0,1,0,1
1429,Bohemian Rhapsody ,0,1,0,1
1430,Banana Split ,0,1,0,1
1431,Ecos de una era ,0,1,0,1
1432,Wojtyla. La investigación ,0,1,0,1
1433,Los Rodríguez y el más allá ,0,1,0,1
1434,Imelda Marcos. Poder en la sombra ,1,0,0,1
1435,Jaque al asesino ,0,1,0,1
1436,Géminis ,1,0,0,1
1437,Fantasy Island ,0,1,0,1
1438,Crimen a contrarreloj ,0,1,0,1
1439,El vuelo del halcón ,0,2,0,2
1440,Operación Panda ,1,0,0,1
1441,"Casanova, su último amor ",0,0,1,1
1442,Corrupción ,0,1,0,1
1443,Buenos principios ,0,1,0,1
1444,Reina de corazones ,1,0,0,1
1445,Hearts and Bones ,0,1,0,1
1446,Lo que te mantiene viva ,0,1,0,1
1447,Las Furias (The Furies) ,0,1,0,1
1448,Un momento en el tiempo (Waves) ,0,1,0,1
1449,Las golondrinas de Kabul ,2,0,0,2
1450,El jilguero ,0,1,0,1
1451,Jay y Bob el silencioso: El reboot ,0,1,0,1
1452,Terminator: Destino oscuro ,0,1,0,1
1453,Shakira en concierto: El Dorado Wolrd Tour ,1,1,0,2
1454,Judy ,0,1,0,1
1455,Vida oculta ,0,1,0,1
1456,Una misión de locos ,0,1,0,1
1457,Mi vida con Amanda ,0,0,1,1
1458,Pavarotti ,0,1,0,1
1459,Socias y enemigas ,0,1,0,1
1460,Pintores y reyes del Prado ,1,0,0,1
1461,Amundsen ,0,1,0,1
1462,Aguas oscuras ,0,1,0,1
1463,Sorry We Missed You ,0,1,0,1
1464,"Tan cerca, tan lejos ",0,1,0,1
1465,Blinded by the Light (Cegado por la luz) ,0,1,0,1
1466,La oveja Shaun. La película: Granjaguedón ,0,2,0,2
1467,Parásitos ,0,1,0,1
1468,Underwater ,0,1,0,1
1469,Cats ,0,1,0,1
1470,Las aventuras del Doctor Dolittle ,0,1,0,1
1471,My Hero Academia: Dos héroes ,0,1,0,1
1472,Descubriendo a Anna Frank. Historias paralelas ,2,0,0,2
1473,Ghostland ,0,1,0,1
1474,¿Adictos a los analgésicos? ,0,0,0,0
1475,Ema ,0,1,0,1
1476,Un atardecer en la Toscana ,0,1,0,1
1477,Mary Beard: Julio César ,0,2,0,2
1478,Familia de policías (Blue Bloods) (Serie de TV),10,31,2,43
1479,Jubilación: imposible ,0,1,0,1
1480,Bajo la misma piel ,0,2,0,2
1481,Perros de presa ,0,1,0,1
1482,Lucha de clases ,0,1,0,1
1483,La lucha por los elefantes ,0,1,0,1
1484,Oda a Joy ,0,1,0,1
1485,Para toda la muerte ,0,1,0,1
1486,Los consejos de Alice ,0,1,0,1
1487,Detective Conan: El puño de zafiro azul ,1,0,0,1
1488,El crack Cero ,0,1,0,1
1489,La Unidad (Serie de TV),0,3,0,3
1490,Zombieland: Mata y remata ,0,1,0,1
1491,Cartas a Roxane ,0,1,0,1
1492,Lucy in the Sky ,0,1,0,1
1493,Cerca del horizonte ,0,1,0,1
1494,Sobre lo infinito ,0,1,0,1
1495,The Boat ,0,1,0,1
1496,Noches mágicas ,0,1,0,1
1497,Madre ,0,1,0,1
1498,La verdad sobre la comida para llevar ,0,0,0,0
1499,Bacurau ,0,2,0,2
1500,Invisible ,1,0,0,1
1501,Cut Off ,0,1,0,1
1502,1917,0,1,0,1
1503,303,0,1,0,1
1504,El ritmo de la venganza ,0,1,0,1
1505,Dios es mujer y se llama Petrunya ,1,0,0,1
1506,¿Por qué no te mueres? ,0,1,0,1
1507,Marianne y Leonard: Palabras de amor ,0,1,0,1
1508,Una pequeña mentira ,0,1,0,1
1509,Ara Malikian: Una vida entre las cuerdas ,1,0,0,1
1510,Predator ,0,1,0,1
1511,El asesino de los caprichos ,0,1,0,1
1512,It. Capítulo 2,0,1,0,1
1513,El faro ,0,1,0,1
1514,Bad Boys for Life ,0,2,0,2
1515,La maldición (The Grudge) ,0,1,0,1
1516,Jojo Rabbit ,1,0,0,1
1517,Blue Story ,0,1,0,1
1518,El mundo de los emojis ,1,0,0,1
1519,Beats ,0,1,0,1
1520,"Hasta siempre, hijo mío ",0,1,0,1
1521,Domino ,0,1,0,1
1522,La luz de mi vida ,0,1,0,1
1523,Bienvenidos al barrio ,0,1,0,1
1524,Vacaciones con mamá ,1,0,0,1
1525,Noche de bodas ,0,2,0,2
1526,La inocencia ,0,0,1,1
1527,Abominable ,1,1,0,2
1528,La guerra de las corrientes ,0,1,0,1
1529,Huérfanos de Brooklyn ,0,1,0,1
1530,Downton Abbey ,0,1,0,1
1531,Antártida: un mensaje de otro planeta ,0,1,0,1
1532,Onward ,0,1,0,1
1533,Incitación ,0,1,0,1
1534,"Sonic, la película ",0,1,0,1
1535,Monos ,0,1,0,1
1536,Rojo ,0,1,0,1
1537,Penny Dreadful: City of Angels (Serie de TV),1,2,0,3
1538,Late Night ,1,0,0,1
1539,Tarantino total ,1,0,0,1
1540,Rambo: Last Blood ,0,1,0,1
1541,La verdad ,0,1,0,1
1542,Érase una vez en... Hollywood ,0,1,0,1
1543,Superman: Hijo rojo ,0,1,0,1
1544,Lo que arde con el fuego ,0,1,0,1
1545,Santuario ,0,1,0,1
1546,El oficial y el espía ,0,1,0,1
1547,Star Wars: El ascenso de Skywalker ,0,0,1,1
1548,A la vuelta de la esquina ,0,1,0,1
1549,¿Qué fue de Jorge Sanz? 5 años después (TV),0,1,0,1
1550,¿Qué fue de Jorge Sanz? III (TV),0,1,0,1
1551,A dos metros de ti ,0,1,0,1
1552,Venganza bajo cero ,0,1,0,1
1553,Ad Astra ,0,1,0,1
1554,Una gran mujer (Beanpole) ,0,1,0,1
1555,Los profesores de Saint-Denis ,0,2,0,2
1556,Tango One ,0,1,0,1
1557,Riverdale (Serie de TV),2,8,0,10
1558,Espías con disfraz ,0,2,0,2
1559,Mujercitas ,1,0,0,1
1560,La chaqueta de piel de ciervo ,0,1,0,1
1561,Will & Grace II (Miniserie de TV),0,3,0,3
1562,Lo que arde ,0,1,0,1
1563,Outlander (Serie de TV),2,9,0,11
1564,Chicos buenos ,0,1,0,1
1565,"Push, mucho más que gentrificación ",0,1,0,1
1566,Dora y la ciudad perdida ,0,1,0,1
1567,Objetivo: Washington D.C. ,0,1,0,1
1568,Rodman: para lo bueno y para lo malo (TV),0,1,0,1
1569,Los niños del mar ,0,1,0,1
1570,Bloodshot ,0,1,0,1
1571,Fin de siglo ,0,1,0,1
1572,Angry Birds 2: La película,0,2,0,2
1573,El joven Sheldon (Serie de TV),0,6,0,6
1574,La directora de orquesta ,1,0,0,1
1575,Better Call Saul (Serie de TV),4,11,0,15
1576,The Good Fight (Serie de TV),4,6,0,10
1577,La línea invisible (Miniserie de TV),0,1,0,1
1578,Schitt's Creek (Serie de TV),0,4,0,4
1579,Fuga de Pretoria ,0,1,0,1
1580,Animado Presidente (Serie de TV),0,7,1,8
1581,Ángel de la muerte ,0,1,0,1
1582,Black Monday (Serie de TV),0,4,0,4
1583,Mi mascota es un dinosaurio ,0,1,0,1
1584,"Elliott Erwitt, el silencio suena bien ",1,0,0,1
1585,El último acto ,0,1,0,1
1586,Tin Star (Serie de TV),1,5,0,6
1587,Un verano en Ibiza ,0,1,0,1
1588,Quien a hierro mata ,0,1,0,1
1589,Puñales por la espalda ,0,1,0,1
1590,The Mustang ,1,0,0,1
1591,Una íntima convicción ,0,1,0,1
1592,Occupied (Serie de TV),4,8,0,12
1593,Nightmare Cinema ,0,4,1,5
1594,Viento de libertad ,0,1,0,1
1595,Coronavirus: Diario de un encierro (TV),0,1,0,1
1596,¿Necesitas una terapeuta sexual? ,0,1,0,1
1597,Freaks ,0,2,0,2
1598,Infierno bajo el agua ,0,1,0,1
1599,Fast & Furious: Hobbs & Shaw ,0,1,0,1
1600,Eighth Grade ,0,1,0,1
1601,Superpoblación (TV),0,1,0,1
1602,Este niño necesita aire fresco ,1,0,0,1
1603,En guerra ,0,1,0,1
1604,Tu fotografía ,0,1,0,1
1605,Tierra de violencia ,0,1,0,1
1606,Playmobil: La película ,0,1,0,1
1607,Annabelle vuelve a casa ,0,1,0,1
1608,La corte de Ana ,0,1,0,1
1609,El final de la verdad ,0,1,0,1
1610,The Birdcatcher. El cazador de pájaros ,0,1,0,1
1611,La virgen de agosto ,0,0,1,1
1612,Stuber Express ,0,1,0,1
1613,City Hunter y el perfume de Cupido ,0,1,0,1
1614,Mascotas 2,0,2,0,2
1615,Justo antes de Cristo (Serie de TV),0,3,2,5
1616,La mejor defensa es un ataque ,0,1,0,1
1617,Espada de confianza ,1,0,0,1
1618,Carne: ¿una amenaza para el planeta? ,0,1,0,1
1619,Los años más bellos de una vida ,0,1,0,1
1620,El vendedor de tabaco ,0,1,0,1
1621,El arte de vivir bajo la lluvia ,0,1,0,1
1622,Por la igualdad en Hollywood ,0,1,0,1
1623,A 47 metros 2,0,1,0,1
1624,Godzilla: Rey de los monstruos ,0,1,0,1
1625,Ven con papá ,0,1,0,1
1626,Hereditary ,0,1,0,1
1627,El hotel a orillas del río ,0,1,0,1
1628,Amor a segunda vista ,0,1,0,1
1629,La querida del Centauro (Serie de TV),1,3,0,4
1630,"Yo, mi mujer y mi mujer muerta ",0,1,0,1
1631,El emperador de París ,0,1,0,1
1632,Spider-Man: Lejos de casa ,0,1,0,1
1633,Virtual Hero: La Serie (Serie de TV),0,2,0,2
1634,Midsommar ,0,1,0,1
1635,El campeón ,0,1,0,1
1636,Utoya. 22 de julio,0,1,0,1
1637,Kidding (Serie de TV),2,4,0,6
1638,Amazing Grace ,0,2,0,2
1639,Al agua gambas ,0,2,0,2
1640,Babylon Berlin (Serie de TV),0,6,0,6
1641,Muñeco diabólico ,0,1,0,1
1642,Los Japón ,0,1,0,1
1643,Harry y Meghan: crisis en la familia real (TV),1,3,0,4
1644,Thomas Markle: su historia (TV),0,1,0,1
1645,¿Por amor o por dinero? ,0,1,0,1
1646,Emergence (Serie de TV),1,2,0,3
1647,Letters to Paul Morrissey ,0,1,0,1
1648,Diane ,0,1,0,1
1649,Un amor imposible ,1,0,0,1
1650,Desaparecida ,1,0,0,1
1651,La biblioteca de los libros rechazados ,0,1,0,1
1652,Rocketman ,0,1,0,1
1653,Elton John confidencial ,0,1,0,1
1654,Vergüenza (Serie de TV),0,4,0,4
1655,Quien quede en pie ,0,1,0,1
1656,One Cut of The Dead ,0,0,1,1
1657,Enemigos íntimos ,0,1,0,1
1658,La clase de piano ,0,1,0,1
1659,Bosque maldito ,0,1,0,1
1660,La trampa de la araña ,0,1,0,1
1661,Skam España (Serie de TV),1,0,0,1
1662,Men in Black International ,0,0,1,1
1663,Los días que vendrán ,0,1,0,1
1664,El creyente ,0,1,0,1
1665,"Soleimani, el poder en la sombra (TV)",0,1,0,1
1666,Farming ,0,1,0,1
1667,Los salvajes (Miniserie de TV),1,0,0,1
1668,La ceniza es el blanco más puro ,1,0,0,1
1669,Shameless (Serie de TV),5,17,0,22
1670,Los muertos no mueren ,0,1,0,1
1671,El cuento de las comadrejas ,0,1,0,1
1672,Yesterday ,0,1,0,1
1673,La banda ,0,1,0,1
1674,Clara y Claire ,1,0,0,1
1675,Largo viaje hacia la noche ,0,1,0,1
1676,El secreto de las abejas ,1,0,0,1
1677,Pequeño gran problema ,1,0,0,1
1678,¡A ganar! ,0,1,0,1
1679,Mientras dure la guerra ,0,1,0,1
1680,El regreso de Aladino ,0,1,0,1
1681,Blaze ,0,1,0,1
1682,Dobles vidas ,0,1,0,1
1683,Work in Progress (Serie de TV),0,1,0,1
1684,L: Generación Q (Serie de TV),2,1,1,4
1685,Llegar a ser Dios en Florida (Miniserie de TV),3,6,0,9
1686,La corresponsal ,0,1,0,1
1687,El sótano de Ma ,0,1,0,1
1688,Pokémon: Detective Pikachu ,0,1,0,1
1689,El embarcadero (Serie de TV),1,2,2,5
1690,Una confesión (Miniserie de TV),0,1,0,1
1691,Un día ,0,1,0,1
1692,Inuyashiki ,0,1,0,1
1693,Ray Donovan (Serie de TV),5,18,0,23
1694,The Affair (Serie de TV),7,13,0,20
1695,La última lección ,0,1,0,1
1696,"Keepers, el misterio del faro ",0,1,0,1
1697,Driven: el origen de la leyenda ,0,1,0,1
1698,La profesora de parvulario ,1,0,0,1
1699,Tolkien ,0,1,0,1
1700,Mia y el león blanco ,0,1,0,1
1701,Aladdin ,0,1,0,1
1702,X-Men: Fénix Oscura ,0,1,0,1
1703,Mula ,0,1,0,1
1704,Podría destruirte (Miniserie de TV),1,0,0,1
1705,Trackers (Serie de TV),0,2,0,2
1706,La estafa (Bad Education) ,0,1,0,1
1707,En casa (Serie de TV),3,2,0,5
1708,Love Life (Serie de TV),0,2,0,2
1709,Stargirl (Serie de TV),3,6,0,9
1710,La innegable verdad (Serie de TV),0,1,0,1
1711,Natalie Wood: Entre bambalinas ,0,1,0,1
1712,Betty (Miniserie de TV),1,0,0,1
1713,We're Here (Serie de TV),0,1,0,1
1714,Mrs. America (Serie de TV),2,1,1,4
1715,El último show (Serie de TV),0,3,0,3
1716,Lo que hacemos en las sombras (Serie de TV),2,2,0,4
1717,Run (Serie de TV),3,0,0,3
1718,Insecure (Serie de TV),3,3,0,6
1719,Killing Eve (Serie de TV),3,3,0,6
1720,Crimen y desaparición en Atlanta: los niños perdidos (Miniserie de TV),0,4,0,4
1721,Future Man (Serie de TV),2,11,0,13
1722,Siren (Serie de TV),6,13,0,19
1723,Auga Seca (Miniserie de TV),0,0,1,1
1724,The Scheme: el escándalo de Christian Dawkins ,0,1,0,1
1725,Posverdad: desinformación y coste de las fake news ,0,1,0,1
1726,La conjura contra América (Miniserie de TV),1,2,0,3
1727,Into the Dark: Good Boy (TV),0,1,0,1
1728,"Roswell, New Mexico (Serie de TV)",5,5,0,10
1729,Westworld (Serie de TV),7,11,0,18
1730,Better Things (Serie de TV),3,3,0,6
1731,Pares y Nones (Serie de TV),0,2,0,2
1732,Devs (Miniserie de TV),0,1,0,1
1733,Dave (Serie de TV),0,3,0,3
1734,Baron noir (Barón negro) (Serie de TV),0,5,0,5
1735,Bendita paciencia (Breeders) (Serie de TV),0,5,0,5
1736,Liar (Serie de TV),0,2,0,2
1737,Contraataque (Serie de TV),0,9,1,10
1738,We Are The Dream: Kids of Oakland MLK Oratorical ,1,0,0,1
1739,Into the Dark: Pooka Lives (TV),0,1,0,1
1740,Katy Keene (Serie de TV),1,4,0,5
1741,McMillions (Serie de TV),0,2,0,2
1742,Tigtone (Serie de TV),0,2,0,2
1743,Avenue 5 (Serie de TV),0,2,0,2
1744,Larry David (Curb Your Enthusiasm) (Serie de TV),0,13,0,13
1745,DC's Legends of Tomorrow (Serie de TV),5,25,1,31
1746,El visitante (Miniserie de TV),2,4,0,6
1747,The New Pope (Serie de TV),0,2,0,2
1748,Wataha (Serie de TV),1,1,0,2
1749,Foodie Love (Serie de TV),1,0,0,1
1750,The Sleepers (Miniserie de TV),0,1,0,1
1751,Ralph Lauren: el hombre detrás de la marca ,1,0,0,1
1752,Santos Dumont (Miniserie de TV),0,1,1,2
1753,La materia oscura (Serie de TV),1,5,0,6
1754,Silicon Valley (Serie de TV),2,8,0,10
1755,La señora Fletcher (Serie de TV),4,1,0,5
1756,Gomorra (Serie de TV),1,7,0,8
1757,Watchmen (Miniserie de TV),1,4,0,5
1758,Buscando a Alaska (Miniserie de TV),1,3,0,4
1759,Embrujadas (Serie de TV),7,9,0,16
1760,Legacies (Serie de TV),5,9,0,14
1761,Umbre (Serie de TV),0,3,0,3
1762,All American (Serie de TV),1,1,0,2
1763,Supergirl (Serie de TV),6,20,0,26
1764,Batwoman (Serie de TV),2,4,0,6
1765,Get Shorty (Serie de TV),2,6,0,8
1766,El padrino de Harlem (Serie de TV),0,3,0,3
1767,Stumptown (Serie de TV),0,3,0,3
1768,Mr. Inbetween (Serie de TV),0,1,0,1
1769,The Deuce (Serie de TV),3,4,0,7
1770,Ballers (Serie de TV),0,6,0,6
1771,Beforeigners (Los visitantes) (Serie de TV),1,2,0,3
1772,Ligera como una pluma (Serie de TV),2,5,1,8
1773,Rick y Morty (Serie de TV),0,11,0,11
1774,Los Gemstone (Serie de TV),0,2,0,2
1775,Our Boys (Serie de TV),0,3,0,3
1776,Succession (Serie de TV),1,7,1,9
1777,Preacher (Serie de TV),2,17,0,19
1778,Pico Da Neblina (Serie de TV),0,4,0,4
1779,A Black Lady Sketch Show (Serie de TV),0,1,0,1
1780,Lambs of God (Miniserie de TV),0,1,0,1
1781,Share ,1,0,0,1
1782,La perturbación (Serie de TV),0,1,0,1
1783,Snowfall (Serie de TV),5,18,0,23
1784,"Te quiero, muérete (Miniserie de TV)",1,0,0,1
1785,El pionero (Miniserie de TV),0,1,0,1
1786,Divorce (Serie de TV),6,6,1,13
1787,Gösta (Serie de TV),0,1,0,1
1788,Los Espookys (Serie de TV),1,3,0,4
1789,Euphoria (Serie de TV),2,3,0,5
1790,Pose (Serie de TV),0,3,0,3
1791,Big Little Lies (Serie de TV),0,3,0,3
1792,El cuento de la criada (Serie de TV),6,5,0,11
1793,Deadwood: La película (TV),0,1,0,1
1794,Juego de Tronos: La última guardia (TV),1,0,0,1
1795,Me llamo Muhammad Ali ,0,1,0,1
1796,Chernobyl (Miniserie de TV),0,2,0,2
1797,The Spanish Princess (Miniserie de TV),4,2,0,6
1798,Gentleman Jack (Serie de TV),3,0,0,3
1799,Six (Serie de TV),2,12,0,14
1800,Juego de tronos (Serie de TV),1,18,1,20
1801,Fosse/Verdon (Miniserie de TV),0,3,0,3
1802,Dr. Nassar: el caso del equipo de Gimnasia de EE. UU. ,1,0,0,1
1803,Hijo nativo (TV),0,1,0,1
1804,Warrior (Serie de TV),1,5,0,6
1805,Muerte en León: Caso cerrado ,0,1,0,1
1806,2 Dope Queens (Serie de TV),3,1,0,4
1807,Crashing (Serie de TV),0,5,0,5
1808,High Maintenance (Serie de TV),1,1,0,2
1809,True Detective III (Miniserie de TV),0,4,0,4
1810,Brexit (TV),0,1,0,1
1811,Success (Serie de TV),1,1,0,2
1812,Runaways (Serie de TV),3,4,0,7
1813,Nox (Miniserie de TV),0,1,0,1
1814,Counterpart (Serie de TV),3,8,0,11
1815,Into the Dark (Serie de TV),5,15,0,20
1816,Into the Dark: Pooka (TV),0,1,0,1
1817,Icebox ,0,1,0,1
1818,Berlin Station (Serie de TV),0,6,0,6
1819,Sally4Ever (Serie de TV),1,0,0,1
1820,Mike Judge Presents: Tales from the Tour Bus (Serie de TV),0,4,0,4
1821,Channel Zero: The Dream Door (Miniserie de TV),0,1,1,2
1822,The Flash (Serie de TV),3,19,1,23
1823,Mayans M.C. (Serie de TV),2,8,1,11
1824,Heathers: Escuela de jóvenes asesinos (Serie de TV),3,3,0,6
1825,La mafia solo mata en verano (Serie de TV),0,2,0,2
1826,Cormoran Strike: El gusano de seda (Miniserie de TV),0,1,0,1
1827,Cormoran Strike: El canto del cuco (Miniserie de TV),0,1,0,1
1828,Cormoran Strike: El oficio del mal (Miniserie de TV),0,1,0,1
1829,All Night (Serie de TV),1,3,0,4
1830,Destino Rusia 2018 (Serie de TV),0,2,0,2
1831,Famous in Love (Serie de TV),4,3,1,8
1832,La travesía (The Crossing) (Serie de TV),1,8,0,9
1833,Trust (Serie de TV),2,4,0,6
1834,Barry (Serie de TV),3,5,0,8
1835,Krypton (Serie de TV),0,3,0,3
1836,El ilusionista (Serie de TV),2,10,0,12
1837,Britannia (Serie de TV),2,2,0,4
1838,Top of the Lake (Serie de TV),1,1,0,2
1839,Top of the Lake: China Girl (Serie de TV),1,1,0,2
1840,Gunpowder (Miniserie de TV),0,1,0,1
1841,Tokyo Project ,0,1,0,1
1842,Knightfall (Serie de TV),0,7,0,7
1843,Channel Zero: La casa sin fin (Miniserie de TV),0,2,0,2
1844,Taboo (Serie de TV),0,3,0,3
1845,The Young Pope (Serie de TV),0,2,0,2
1846,The Knick (Serie de TV),0,3,0,3
1847,Feud: Bette and Joan (Miniserie de TV),3,3,0,6
1848,Magic City (Serie de TV),0,8,0,8
1849,Raíces (Miniserie de TV),0,4,0,4
1850,Rellik (Miniserie de TV),0,4,0,4
1851,La Princesa Blanca (Serie de TV),0,2,0,2
1852,La Reina Blanca (Serie de TV),0,3,0,3
1853,When We Rise (Miniserie de TV),1,4,0,5
1854,No Offence (Serie de TV),1,4,0,5
1855,Death and Nightingales (Miniserie de TV),0,1,0,1
1856,Manifest (Serie de TV),5,9,1,15
1857,La chica de oro ,1,1,0,2
1858,Greener Grass ,2,0,0,2
1859,"A Bread Factory, Part One ",0,1,0,1
1860,"A Bread Factory, Part Two ",0,1,0,1
1861,La ruta del dinero (Serie de TV),0,7,0,7
1862,La casa de verano ,1,0,0,1
1863,La casa lobo ,0,1,1,2
1864,Rocambola ,0,1,0,1
1865,Hasta que la boda nos separe ,0,1,0,1
1866,La arrancada ,0,1,0,1
1867,El nido (Miniserie de TV),0,2,0,2
1868,Mi nombre es Baghdad ,1,0,0,1
1869,La candidata perfecta ,1,0,0,1
1870,El regreso ,0,1,0,1
1871,El destierro ,0,1,0,1
1872,Dragged Across Concrete ,0,0,1,1
1873,La protagonista ,1,0,0,1
1874,Hombre en la llanura ,0,1,0,1
1875,Drag Kids ,1,0,0,1
1876,1985,1,0,0,1
1877,Deep Water (Miniserie de TV),0,3,0,3
1878,Skate Kitchen ,1,0,0,1
1879,Continuar ,0,1,0,1
1880,Entre la razón y la locura ,0,1,0,1
1881,We Go Way Back ,1,0,0,1
1882,Horizon ,1,0,0,1
1883,Una receta familiar ,0,1,0,1
1884,Exhibition ,1,0,0,1
1885,Unrelated ,1,0,0,1
1886,El incendio (Miniserie de TV),2,0,0,2
1887,A Colony ,0,0,1,1
1888,El viento entre las cañas ,2,3,0,5
1889,Parking ,0,1,0,1
1890,CRSHD ,1,0,0,1
1891,¿Recuerdas? ,0,1,0,1
1892,Nevrland ,0,1,0,1
1893,Moira ,0,1,0,1
1894,Quinqui Stars ,0,1,0,1
1895,Stray Dogs ,0,1,0,1
1896,Journey to the West ,0,1,0,1
1897,Elefantes ,0,1,0,1
1898,La Rusa ,0,1,0,1
1899,Maravillas en Montfermeil ,1,0,0,1
1900,Neighbors ,0,0,1,1
1901,Un genio llamado Phil Tippett ,0,2,0,2
1902,El juego del asesino ,0,1,0,1
1903,Sanditon (Miniserie de TV),1,2,0,3
1904,"Maquia, una historia de amor inmortal ",1,0,0,1
1905,Petra ,0,1,0,1
1906,El captor ,0,1,0,1
1907,Solo nos queda bailar ,0,1,0,1
1908,Skin ,0,1,0,1
1909,Cold War ,0,1,0,1
1910,Bombshell: La historia de Hedy Lamarr ,1,0,0,1
1911,Blood (Serie de TV),3,0,0,3
1912,La causa contra Franco ,0,1,1,2
1913,Hijos de la ultraderecha ,1,0,0,1
1914,Anon ,0,1,0,1
1915,Desvelando la verdad ,0,1,0,1
1916,Bajo sospecha ,0,1,0,1
1917,RBG ,2,0,0,2
1918,The Price of Everything ,0,1,0,1
1919,The Bay (Serie de TV),0,2,0,2
1920,The Rider ,0,0,1,1
1921,Eden (Miniserie de TV),1,2,0,3
1922,"Feliz año, abuela ",0,1,0,1
1923,Asamblea ,0,0,1,1
1924,La ciudad oculta ,0,0,1,1
1925,Last Child ,0,1,0,1
1926,Los buenos modales ,1,1,0,2
1927,Studio 54,0,1,0,1
1928,Endeavour (Serie de TV),3,20,1,24
1929,Cocote ,0,1,0,1
1930,Enamorado de mi mujer ,0,1,0,1
1931,Parabellum ,0,1,0,1
1932,Longa noite ,0,1,0,1
1933,Ex Libris: La biblioteca pública de Nueva York ,0,1,0,1
1934,The Ghoul ,0,1,0,1
1935,Pure (Serie de TV),1,1,0,2
1936,Knife + Heart ,0,1,0,1
1937,Curiosa ,1,0,0,1
1938,Insumisas ,1,1,0,2
1939,"Antonio Lopez 1970: Sex, Fashion & Disco",0,1,0,1
1940,"Amar, beber y cantar ",0,1,0,1
1941,La espera ,0,1,0,1
1942,Felices sueños ,0,1,0,1
1943,La carga ,0,1,0,1
1944,La chica dormida ,1,0,0,1
1945,Jesús ,0,1,0,1
1946,El pequeño Quinquin (Miniserie de TV),0,1,0,1
1947,Kevyn Aucoin. El maquillador de las estrellas ,1,0,0,1
1948,Un minuto de gloria (Glory) ,1,1,0,2
1949,TURN: Espías de Washington (Serie de TV),4,18,1,23
1950,La muerte de Stalin ,0,1,0,1
1951,"Jeannette, la infancia de Juana de Arco ",0,1,0,1
1952,El hombre que diseñó España ,0,2,0,2
1953,Emma Peeters ,1,0,0,1
1954,Dead Set: Muerte en directo (Miniserie de TV),0,2,0,2
1955,Paso al límite ,1,0,0,1
1956,Picotazos contra el cristal ,0,2,0,2
1957,Halt and Catch Fire (Serie de TV),8,14,0,22
1958,Hilos de sororidad ,0,1,0,1
1959,The Love Witch ,1,0,0,1
1960,Saw VIII ,0,3,0,3
1961,La fábrica de nada ,0,1,0,1
1962,Gloria Mundi ,0,1,0,1
1963,Love Me Not ,0,0,1,1
1964,1989,0,1,1,2
1965,Diarios de la Gran Guerra (Miniserie de TV),0,1,0,1
1966,"Bobby, el erizo ",0,1,0,1
1967,El hombre que inventó la Navidad ,0,1,0,1
1968,La flor ,0,1,0,1
1969,Rodin ,0,1,0,1
1970,Grass ,0,1,0,1
1971,The Day After ,0,1,0,1
1972,La cámara de Claire ,0,1,0,1
1973,En la playa sola de noche ,0,1,0,1
1974,Lo tuyo y tú ,0,1,0,1
1975,"Ahora sí, antes no ",0,1,0,1
1976,Exit (Serie de TV),0,1,0,1
1977,Fourteen ,0,1,0,1
1978,El viaje de Nisha ,1,0,0,1
1979,Swinging Safari ,0,1,0,1
1980,La gran hambruna ,0,1,0,1
1981,Brothers' Nest ,0,1,0,1
1982,Las niñas bien ,1,0,0,1
1983,Darkness: La huella del crimen (Serie de TV),0,1,0,1
1984,El último gran robo (Miniserie de TV),0,1,0,1
1985,Sin filtro ,0,1,0,1
1986,The Door ,0,1,0,1
1987,El Estado contra Mandela y los otros ,0,2,0,2
1988,El hijo de Winnetou ,0,1,0,1
1989,La leyenda de Longwood ,1,0,0,1
1990,Un perro ladrando a la luna ,1,0,0,1
1991,El extraño color de las lágrimas de tu cuerpo ,1,1,0,2
1992,Dejad que los cadáveres se bronceen ,1,1,0,2
1993,Charité en guerra (Miniserie de TV),0,0,0,0
1994,Medida por medida ,0,1,0,1
1995,Mike Wallace Is Here ,0,1,0,1
1996,Matangi / Maya / M.I.A. ,0,1,0,1
1997,Hugo en el país de los elfos ,0,1,0,1
1998,Electric Swan ,1,0,0,1
1999,Goltzius and the Pelican Company ,0,1,0,1
2000,Cara a cara (Forhøret) (Serie de TV),0,1,0,1
2001,Solan & Eri: Misión a la Luna ,0,1,0,1
2002,Happy End ,0,1,0,1
2003,Ray y Liz ,0,1,0,1
2004,En la playa de Chesil ,0,1,0,1
2005,Everyday ,0,1,0,1
2006,Yo la busco ,1,0,0,1
2007,Detour ,0,1,0,1
2008,La ciudad de la violencia ,0,1,0,1
2009,Gentlemen ,0,1,0,1
2010,Trote ,0,1,0,1
2011,Conexión Estambul (TV),0,1,0,1
2012,Blinded (Fartblinda) (Serie de TV),0,2,0,2
2013,Las guardianas ,0,1,0,1
2014,No Stranger Than Love ,0,1,0,1
2015,The Cured ,0,1,0,1
2016,El orden divino ,1,0,0,1
2017,Brighton Rock ,0,1,0,1
2018,Scary Mother ,1,0,0,1
2019,Blue Iguana ,0,1,0,1
2020,La mujer de blanco (Miniserie de TV),0,1,0,1
2021,The Last Fiction ,0,1,0,1
2022,La lectora ,0,1,0,1
2023,An Elephant Sitting Still ,0,1,0,1
2024,La número uno ,0,1,0,1
2025,Los 50 son los nuevos 30,1,0,0,1
2026,Kusama: Infinito ,1,0,0,1
2027,Los testigos de Putin ,0,1,0,1
2028,Utopia (Serie de TV),0,4,0,4
2029,Segunda estrella a la derecha ,1,0,0,1
2030,Golpe de sol ,0,1,0,1
2031,El cuento número trece ,0,1,0,1
2032,"Bauhaus, una nueva era (Serie de TV)",0,2,0,2
2033,Treufoc (Serie de TV),0,3,0,3
2034,The Habit of Beauty ,0,1,0,1
2035,Hannah ,0,1,0,1
2036,Jonathan Strange & Mr Norrell (Miniserie de TV),0,1,0,1
2037,La mujer que sabía leer ,1,0,0,1
2038,Match (Serie de TV),1,1,0,2
2039,Delphine y Carole ,0,1,0,1
2040,Caballo dinero ,0,1,0,1
2041,Lucky ,0,1,0,1
2042,Guerra y paz (Miniserie de TV),0,1,0,1
2043,La felicidad de los perros ,0,1,0,1
2044,Sniper: Assassin's End ,0,1,0,1
2045,"Manolo Sanlúcar, el legado ",0,1,0,1
2046,¡Vamos a cazar un oso! (C),1,1,0,2
2047,Speed Kills ,1,0,0,1
2048,La nueva vida de Britt-Marie ,1,0,0,1
2049,Como entrenar tu dragón: vuelta a casa (C),0,1,0,1
2050,Adú ,0,1,0,1
2051,Framed ,0,1,0,1
2052,La cabaña siniestra ,1,1,0,2
2053,Rob Ford: Crónica de un escándalo ,0,1,0,1
2054,Andrés Iniesta – El héroe inesperado ,0,1,0,1
2055,El misterio del dragón ,0,1,0,1
2056,You Go to My Head ,0,1,0,1
2057,El reflejo de Sibyl ,1,0,0,1
2058,Renacidos: El Padre Pío cambió sus vidas ,0,1,0,1
2059,"Dios mío, ¿pero qué te hemos hecho... ahora? ",0,1,0,1
2060,Spy Cat ,0,2,0,2
2061,Vivarium ,0,1,0,1
2062,La alegría de las pequeñas cosas ,0,1,0,1
2063,Especiales ,0,2,0,2
2064,Jugando con fuego ,0,1,0,1
2065,Bull ,1,0,0,1
2066,La Pasión en el arte ,0,1,0,1
2067,Jumanji: Siguiente nivel ,0,1,0,1
2068,Malasaña 32,0,1,0,1
2069,La fábrica de sueños ,0,1,0,1
2070,Navidad sangrienta ,1,0,0,1
2071,La odisea de los giles ,0,0,1,1
2072,One Piece: Estampida ,0,1,0,1
2073,El traidor ,0,1,0,1
2074,La gran mentira ,0,1,0,1
2075,The Wonderland ,0,1,0,1
2076,La hija de un ladrón ,0,0,1,1
2077,Midway ,0,1,0,1
2078,Los miserables ,0,1,0,1
2079,La vida invisible de Eurídice Gusmão ,0,1,0,1
2080,Intemperie ,0,1,0,1
2081,La casa del terror (Haunt) ,0,2,0,2
2082,Pequeñas mentiras para estar juntos ,0,1,0,1
2083,Retrato de una mujer en llamas ,1,0,0,1
2084,Si yo fuera rico ,0,1,0,1
2085,Le Mans '66,0,1,0,1
2086,7 razones para huir,0,3,0,3
2087,Estafadoras de Wall Street ,1,0,0,1
2088,Secretos de Estado ,0,1,0,1
2089,El viaje de Marta (Staff Only) ,1,0,0,1
2090,Manou ,0,2,0,2
2091,Tabaluga y la princesa de hielo ,0,1,0,1
2092,La mensajera ,0,1,0,1
2093,Abigail y la ciudad perdida ,0,1,0,1
2094,The Informer ,0,1,0,1
2095,Anna ,0,1,0,1
2096,En mil pedazos ,0,1,0,1
2097,Litus ,0,1,0,1
2098,El papel de sus vidas ,1,0,0,1
2099,10 minutos menos,0,1,0,1
2100,El cocinero de los últimos deseos ,0,0,1,1
2101,Juguetes guardianes ,0,1,0,1
2102,Untouchable (Intocable) ,1,0,0,1
2103,El gran Buster ,0,1,0,1
2104,Primeras vacaciones ,0,1,0,1
2105,Ayla: La hija de la guerra ,0,1,0,1
2106,Alcanzando tu sueño (Teen Spirit) ,0,1,0,1
2107,En busca del Óscar ,0,1,0,1
2108,The Song of Sway Lake ,0,1,0,1
2109,Buscando la perfección ,0,1,0,1
2110,Te presento a Sofia ,0,1,0,1
2111,El soldado perdido ,0,1,0,1
2112,Entendiendo a Ingmar Bergman ,2,1,0,3
2113,La mirada de Orson Welles ,0,1,0,1
2114,Assassination Classroom: La graduación ,0,0,1,1
2115,Assassination Classroom ,0,0,1,1
2116,Varda por Agnès ,1,0,0,1
2117,Más allá de la esperanza ,1,0,0,1
2118,The Last Narc (Miniserie de TV),0,1,0,1
2119,"Amaia, una vuelta al sol ",0,1,0,1
2120,Hanna (Serie de TV),2,3,0,5
2121,Homecoming 2 (Serie de TV),1,2,0,3
2122,Relatos con-fin-a-dos (Miniserie de TV),1,6,0,7
2123,Desaparecidos (Serie de TV),1,2,0,3
2124,Happiness Continues ,0,1,0,1
2125,The Vast of Night ,0,1,0,1
2126,Bosch (Serie de TV),3,13,0,16
2127,Madres: Amor y vida (Serie de TV),4,0,0,4
2128,Historias del bucle (Serie de TV),3,6,0,9
2129,El Presidente (Miniserie de TV),1,4,0,5
2130,Little Fires Everywhere (Miniserie de TV),1,0,0,1
2131,Guns Akimbo ,0,1,0,1
2132,Derribad al hombre ,2,0,0,2
2133,Sesión salvaje ,0,2,0,2
2134,Brittany corre una maratón ,0,1,0,1
2135,Doblemente embarazada ,0,1,0,1
2136,ZeroZeroZero (Serie de TV),0,6,0,6
2137,Star Trek: Picard (Serie de TV),2,4,0,6
2138,Caronte (Serie de TV),1,1,1,3
2139,Upload (Serie de TV),0,2,0,2
2140,Hunters (Serie de TV),1,6,0,7
2141,The Pale Horse (Miniserie de TV),1,0,0,1
2142,The Report ,0,1,0,1
2143,Modern Love (Serie de TV),2,2,0,4
2144,Treadstone (Serie de TV),0,2,0,2
2145,El juego de las llaves (Serie de TV),1,2,0,3
2146,Ted Bundy: Enamorada de un asesino (Miniserie de TV),1,0,0,1
2147,Savage X Fenty Show (TV),1,1,0,2
2148,El corazón de Sergio Ramos (Miniserie de TV),0,1,0,1
2149,The Boys (Serie de TV),1,9,0,10
2150,Demasiado viejo para morir joven (Serie de TV),0,3,0,3
2151,Fleabag (Serie de TV),1,2,0,3
2152,Troop Zero ,0,1,0,1
2153,Good Omens (Miniserie de TV),0,2,0,2
2154,The Aeronauts ,0,1,0,1
2155,Hernán (Serie de TV),1,2,1,4
2156,Atrapa a un ladrón (Serie de TV),0,2,0,2
2157,El pueblo (Serie de TV),1,3,0,4
2158,Lorena (Miniserie de TV),0,1,0,1
2159,Los Romanov (Miniserie de TV),0,2,0,2
2160,The Purge (Serie de TV),2,5,0,7
2161,"Luis, el sabio del éxito ",0,0,0,0
2162,Pequeñas coincidencias (Serie de TV),0,1,0,1
2163,Molly's Game ,0,1,0,1
2164,Six Dreams (Serie de TV),0,3,0,3
2165,Gringo: Se busca vivo o muerto ,0,1,0,1
2166,El libro peligroso para los chicos (Serie de TV),0,2,0,2
2167,Uno tan diferente como yo ,0,1,0,1
2168,The Last Witch ,0,1,0,1
2169,The Looming Tower (Miniserie de TV),0,7,0,7
2170,McMafia (Serie de TV),0,3,0,3
2171,En la sombra ,0,1,0,1
2172,Philip K. Dick's Electric Dreams (Serie de TV),2,8,0,10
2173,Hecho en el cielo (Serie de TV),5,1,0,6
2174,New Amsterdam (Serie de TV),5,10,0,15
2175,"La economía global, esa enorme bestia (Serie de TV)",0,2,0,2
2176,Tokyo Girl (Serie de TV),1,0,0,1
2177,Eterno ,0,1,0,1
2178,Originalos (Serie de TV),0,1,0,1
2179,Grand Prix Driver (Serie de TV),0,1,0,1
2180,El ayuda de cámara (TV),0,1,0,1
2181,Long Strange Trip ,0,1,0,1
2182,American Gods (Serie de TV),5,9,0,14
2183,Jean-Claude Van Johnson (Serie de TV),0,2,0,2
2184,La garrapata (Serie de TV),5,5,0,10
2185,Hasta que la boda nos separe ,0,1,0,1
2186,Diablo Guardián (Serie de TV),1,3,0,4
2187,Dietland (Serie de TV),2,0,0,2
2188,Fools ,0,1,0,1
2189,Tokyo Vampire Hotel (Serie de TV),0,1,0,1
2190,Kamen Rider Amazons (Serie de TV),0,3,0,3
2191,Inside Edge (Serie de TV),0,1,1,2
2192,Breathe (Serie de TV),0,1,0,1
2193,Loudermilk (Serie de TV),0,4,0,4
2194,Patriota (Serie de TV),0,6,0,6
2195,Zone Blanche (Serie de TV),0,2,0,2
2196,The Bold Type (Serie de TV),2,2,0,4
2197,El hombre en el castillo (Serie de TV),1,17,0,18
2198,Forever (Serie de TV),0,4,1,5
2199,Persiguiendo la felicidad ,0,1,0,1
2200,Café con Ana ,0,1,0,1
2201,The Grand Tour (Serie de TV),0,7,0,7
2202,Mozart in the Jungle (Serie de TV),3,14,0,17
2203,Red Oaks (Serie de TV),2,5,0,7
2204,Businessmen vs. Aliens (Miniserie de TV),0,0,1,1
2205,Mirapur (Serie de TV),0,4,1,5
2206,El último magnate (Serie de TV),4,3,0,7
2207,La mano de Dios (Serie de TV),1,8,0,9
2208,Crisis en seis escenas (Miniserie de TV),0,1,0,1
2209,Goliat (Serie de TV),0,6,0,6
2210,El playboy americano: La historia de Hugh Heffner (Serie de TV),0,1,0,1
2211,Le Mans: Una carrera apasionante (Serie de TV),0,1,0,1
2212,Mis experiencias sexuales con Dick (Serie de TV),2,0,0,2
2213,Mitos y leyendas (Serie de TV),1,6,0,7
2214,11:23 - 9:59 (Proyecto Angst),0,2,0,2
2215,Sneaky Pete (Serie de TV),3,8,0,11
2216,Dueños del paraíso (Serie de TV),1,1,2,4
2217,La rebelión de las chicas buenas (Serie de TV),7,2,0,9
2218,Hapimari: Happy Marriage!? (Serie de TV),0,0,2,2
2219,En abril ,0,1,0,1
2220,"Jack Ryan, de Tom Clancy (Serie de TV)",1,5,0,6
2221,Galaxia creativa (Serie de TV),2,2,0,4
2222,Transparent (Serie de TV),5,3,0,8
2223,Con ella empezó todo (Serie de TV),4,3,0,7
2224,Las Kicks (Serie de TV),2,2,0,4
2225,Puro Misisipi (Serie de TV),2,3,0,5
2226,You Are Wanted (Serie de TV),0,5,0,5
2227,Mariposas verdes ,0,1,0,1
2228,Fukuyado Honpo: Kyoto Love Story (Serie de TV),0,0,1,1
2229,CODumentary ,0,1,0,1
2230,Covert Affairs (Serie de TV),2,8,2,12
2231,The Magicians (Serie de TV),8,10,0,18
2232,Todo o nada (Serie de TV),1,1,0,2
2233,Los débiles ,0,2,0,2
2234,El sexo y la Sra. X (TV),0,1,0,1
2235,Vampire Clay ,0,0,1,1
2236,Malos días ,0,0,1,1
2237,Vivir y otras ficciones ,0,1,0,1
2238,Bronce ,0,1,0,1
2239,Grand Blue (Serie de TV),0,1,0,1
2240,La maravillosa Sra. Maisel (Serie de TV),2,4,0,6
2241,La viuda (Miniserie de TV),0,2,0,2
2242,Kung Fu Panda: The Paws of Destiny (Serie de TV),0,2,0,2
2243,All or Nothing: Manchester City (Serie de TV),0,1,0,1
2244,Beat (Serie de TV),0,1,0,1
2245,The Gymkhana Files (Serie de TV),0,1,0,1
2246,All or Nothing: New Zealand All Blacks (Serie de TV),0,0,0,0
2247,Four More Shots Please (Serie de TV),1,0,0,1
2248,Carnival Row (Serie de TV),1,5,0,6
2249,Futbolistas por el mundo (Miniserie de TV),1,0,0,1
2250,Cómo sobrevivir soltero (Serie de TV),0,5,2,7
2251,El cascanueces y los cuatro reinos ,0,2,0,2
2252,Maléfica: Maestra del mal ,0,1,0,1
2253,Salir (C),0,1,0,1
2254,Una vuelta (C),1,0,0,1
2255,Forky hace una pregunta: ¿Qué es la lectura? (Ep) (C),0,1,0,1
2256,Los Vengadores del futuro de Marvel (Serie de TV),0,0,1,1
2257,Las locas aventuras de Chip y Chop (Serie de TV),0,2,0,2
2258,Marvel Rising: Corazón de hierro (TV),1,1,0,2
2259,Marvel Rising: La batalla de las bandas (TV),0,1,0,1
2260,Taylor Swift: City of Lover Concert ,0,1,0,1
2261,Forky hace una pregunta: ¿Qué es el queso? (Ep) (C),0,1,0,1
2262,Una vida de perros con Bill Farmer (Serie de TV),0,1,0,1
2263,Forky hace una pregunta: ¿Qué es una mascota? (Ep) (C),0,1,0,1
2264,Christopher Robin ,0,1,0,1
2265,Los Descendientes 3 (TV),0,1,0,1
2266,Galería Disney: Star Wars: The Mandalorian (Serie de TV),0,1,0,1
2267,Cultura (Serie de TV),0,1,0,1
2268,Forky hace una pregunta: ¿Qué es un líder? (Ep) (C),0,1,0,1
2269,Viento (C),0,1,0,1
2270,Forky hace una pregunta: ¿Qué es un ordenador? (Ep) (C),0,1,0,1
2271,Forky hace una pregunta: ¿Qué es el amor? (Ep) (C),0,1,0,1
2272,Maggie Simpson: Jugando con el destino (C),0,1,0,1
2273,Una celebración de la música de Coco ,0,1,0,1
2274,Forky hace una pregunta: ¿Qué es el tiempo? (Ep) (C),0,1,0,1
2275,Eduardo Manostijeras ,0,1,0,1
2276,Carlitos y Snoopy: La película de Peanuts ,0,1,0,1
2277,Los elefantes ,1,2,0,3
2278,"Delfines, la vida en el arrecife ",0,1,0,1
2279,Forky hace una pregunta: ¿Qué es el arte? (Ep) (C),0,1,0,1
2280,Penguins ,0,2,0,2
2281,Los pingüinos de la Antártida ,0,2,0,2
2282,The Mandalorian (Serie de TV),3,6,0,9
2283,Tras los pasos del elefante ,1,0,0,1
2284,Forky hace una pregunta: ¿Qué es la amistad? (Ep) (C),0,1,0,1
2285,Nadando con delfines ,0,1,0,1
2286,Togo ,0,1,0,1
2287,Desastre y Total: Agencia de detectives nº1,0,1,0,1
2288,La dama y el vagabundo ,0,1,0,1
2289,Las aventuras de Bo Peep (C),1,0,0,1
2290,High School Musical. El Musical: La Serie (Serie de TV),0,2,0,2
2291,Star Wars: The Clone Wars. La temporada final (Serie de TV),0,7,0,7
2292,Forky hace una pregunta (Serie de TV),0,1,0,1
2293,Stargirl ,1,0,0,1
2294,Un día en Disney (Serie de TV),0,0,0,0
2295,El mundo según Jeff Goldblum (Serie de TV),1,2,0,3
2296,Pixar en la vida real (Serie de TV),0,1,0,1
2297,The Imagineering Story (Miniserie de TV),1,0,0,1
2298,Vuela (C),0,1,0,1
2299,Forky hace una pregunta: ¿Qué es el dinero? (Ep) (C),0,1,0,1
2300,Elegidos para guiar (Miniserie de TV),1,1,0,2
2301,Diario de una futura presidenta (Serie de TV),2,0,0,2
2302,Ice Age: En busca del huevo (TV),0,1,0,1
2303,High School Musical: El Musical: La Serie: El Especial (TV) (C),0,1,0,1
2304,Marvel: Proyecto Héroes (Serie de TV),0,1,0,1
2305,Circuito de cortos (Serie de TV),4,10,0,14
2306,Charcos (C),0,1,0,1
2307,Estudiantes de intercambio (C),1,0,0,1
2308,El peluquín de la suerte (C),1,0,0,1
2309,Pensamientos al descubierto (C),0,1,0,1
2310,Etapas de la vida (C),0,1,0,1
2311,El rayo mágico (C),0,1,0,1
2312,La carrera (C),0,1,0,1
2313,Pel-Jitsu (C),0,1,0,1
2314,Downtown (C),1,0,0,1
2315,Jing Hua (Flor en el espejo) (C),0,1,0,1
2316,La gota (C),0,1,0,1
2317,Cénit (C),1,0,0,1
2318,Un elefante en mi cuarto (C),0,1,0,1
2319,La búsqueda de Óliver (C),0,1,0,1
2320,La Leyenda de los Tres Caballeros (Serie de TV),0,3,0,3
2321,Marvel Rising: Secret Warriors (TV),0,1,0,1
2322,Central Park (Serie de TV),1,7,0,8
2323,Greyhound ,0,1,0,1
2324,Fraggle Rock: Rock On! (Serie de TV),0,1,0,1
2325,Cuentos asombrosos: La grieta (TV),0,1,0,1
2326,Home Before Dark (Serie de TV),4,1,0,5
2327,Cuentos asombrosos: Signos vitales (TV),0,1,0,1
2328,Cuentos asombrosos: ¡Dynoman y Voltio! (TV),1,0,0,1
2329,Cuentos asombrosos: La eliminatoria (TV),0,1,0,1
2330,Cuentos asombrosos: El sótano (TV),0,1,0,1
2331,See (Serie de TV),0,5,0,5
2332,Truth Be Told (Serie de TV),3,3,0,6
2333,Servant (Serie de TV),1,2,1,4
2334,El banquero ,0,1,0,1
2335,Dads ,0,1,0,1
2336,The Morning Show (Serie de TV),3,3,0,6
2337,Estamos aquí: Notas para vivir en el Planeta Tierra ,0,2,0,2
2338,Dickinson (Serie de TV),1,1,0,2
2339,El escritor fantasma (Ghostwriter) (Serie de TV),0,1,0,1
2340,Para toda la humanidad (Serie de TV),1,6,0,7
2341,Little Voice (Serie de TV),3,2,0,5
2342,Mythic Quest: Raven's Banquet (Serie de TV),1,2,0,3
2343,Snoopy en el espacio (Serie de TV),0,4,0,4
2344,Helpsters (Serie de TV),2,4,0,6
2345,Reina de elefantes ,1,1,0,2
2346,Wolfwalkers ,0,2,0,2
2347,Fundación (Serie de TV),0,1,0,1
2348,Hala ,0,1,0,1
2349,Little America (Serie de TV),3,4,0,7
2350,Visibilidad: LGTBI en la televisión (Serie de TV),0,1,0,1
2351,Cuentos asombrosos (Serie de TV),1,7,0,8
2352,Beastie Boys Story ,0,1,0,1
2353,Defender a Jacob (Miniserie de TV),0,2,0,2
2354,Ciclos (Serie de TV),0,1,0,1
2355,Dear... (Serie de TV),2,4,1,7
2356,Little Joe ,1,0,0,1
2357,The Gentlemen: Los señores de la mafia ,0,1,0,1
2358,El hombre invisible ,0,1,0,1
2359,Cuestión de justicia ,0,1,0,1
2360,Matthias & Maxime ,0,1,0,1
2361,Los lobos ,0,1,0,1
2362,La familia Samuni ,0,1,0,1
2363,Personal Assistant ,1,0,0,1
2364,La cinta de Álex ,1,0,0,1
2365,Cinema Paradiso ,0,1,0,1
2366,Corre como una chica ,1,0,0,1
2367,"Un blanco, blanco día ",0,1,0,1
2368,La posesión de Mary ,0,1,0,1
2369,Alpha ,0,1,0,1
2370,Alexa & Katie (Serie de TV),2,3,0,5
2371,Artemis Fowl ,0,1,0,1
2372,Animazén (Miniserie de TV),0,1,0,1
2373,Once Were Brothers: Robbie Robertson and The Band ,0,1,0,1
2374,Sr. Iglesias (Serie de TV),1,7,0,8
2375,El límite infinito ,0,1,0,1
2376,Amor de gata ,0,2,0,2
2377,La orden (Serie de TV),3,3,0,6
2378,El rey: monarca eterno (Serie de TV),0,1,0,1
2379,La red Avispa ,0,1,0,1
2380,The Sinner 3 (Miniserie de TV),0,2,0,2
2381,Coisa Mais Linda (Serie de TV),0,1,0,1
2382,The Politician (Serie de TV),2,3,0,5
